,release_date,movie,production_budget,domestic_gross,worldwide_gross,foreign_gross,profit,release_year,genres,director,roi_domestic,roi_foreign,roi_worldwide
0,2011-05-20,Pirates of the Caribbean: On Stranger Tides 2011,410600000,241063875,1045663875,804600000,635063875,2011,"Action,Adventure,Fantasy",Rob Marshall,-41.28985021919143,95.95713589868485,154.6672856794934
1,2019-06-07,Dark Phoenix 2019,350000000,42762350,149762350,107000000,-200237650,2019,"Action,Adventure,Sci-Fi",Simon Kinberg,-87.7821857142857,-69.42857142857143,-57.21075714285714
2,2015-05-01,Avengers: Age of Ultron 2015,330600000,459005868,1403013963,944008095,1072413963,2015,"Action,Adventure,Sci-Fi",Joss Whedon,38.84025045372051,185.543888384755,324.38413883847545
3,2018-04-27,Avengers: Infinity War 2018,300000000,678815482,2048134200,1369318718,1748134200,2018,"Action,Adventure,Sci-Fi","Anthony Russo, Joe Russo",126.27182733333333,356.43957266666666,582.7114
4,2017-11-17,Justice League 2017,300000000,229024295,655945209,426920914,355945209,2017,"Action,Adventure,Fantasy",Zack Snyder,-23.65856833333333,42.30697133333333,118.64840299999999
5,2015-11-06,Spectre 2015,300000000,200074175,879620923,679546748,579620923,2015,"Action,Adventure,Thriller",Sam Mendes,-33.30860833333333,126.51558266666667,193.20697433333333
6,2012-07-20,The Dark Knight Rises 2012,275000000,448139099,1084439099,636300000,809439099,2012,"Action,Thriller",Christopher Nolan,62.959672363636365,131.38181818181818,294.3414905454545
7,2018-05-25,Solo: A Star Wars Story 2018,275000000,213767512,393151347,179383835,118151347,2018,"Action,Adventure,Fantasy",Ron Howard,-22.266359272727275,-34.76951454545454,42.96412618181818
8,2013-07-02,The Lone Ranger 2013,275000000,89302115,260002115,170700000,-14997885,2013,"Action,Adventure,Western",Gore Verbinski,-67.52650363636363,-37.92727272727273,-5.453776363636364
9,2012-03-09,John Carter 2012,275000000,73058679,282778100,209719421,7778100,2012,"Action,Adventure,Sci-Fi",Andrew Stanton,-73.43320763636363,-23.73839236363636,2.8284
11,2016-05-06,Captain America: Civil War 2016,250000000,408084349,1140069413,731985064,890069413,2016,"Action,Adventure,Sci-Fi","Anthony Russo, Joe Russo",63.23373960000001,192.7940256,356.0277652
12,2016-03-25,Batman v Superman: Dawn of Justice 2016,250000000,330360194,867500281,537140087,617500281,2016,"Action,Adventure,Fantasy",Zack Snyder,32.144077599999996,114.85603479999999,247.0001124
13,2012-12-14,The Hobbit: An Unexpected Journey 2012,250000000,303003568,1017003568,714000000,767003568,2012,"Adventure,Family,Fantasy",Peter Jackson,21.2014272,185.60000000000002,306.80142720000003
14,2013-12-13,The Hobbit: The Desolation of Smaug 2013,250000000,258366855,960366855,702000000,710366855,2013,"Adventure,Fantasy",Peter Jackson,3.346742,180.8,284.14674199999996
15,2014-12-17,The Hobbit: The Battle of the Five Armies 2014,250000000,255119788,945577621,690457833,695577621,2014,"Adventure,Fantasy",Peter Jackson,2.0479152000000003,176.18313320000001,278.23104839999996
16,2017-04-14,The Fate of the Furious 2017,250000000,225764765,1234846267,1009081502,984846267,2017,"Action,Crime,Thriller",F. Gary Gray,-9.694094,303.63260080000003,393.9385068
17,2017-05-26,Pirates of the Caribbean: Dead Men Tell No Tales 2017,230000000,172558876,788241137,615682261,558241137,2017,"Action,Adventure,Fantasy","Joachim RÃ¸nning, Espen Sandberg",-24.974401739130432,167.6879395652174,242.71353782608696
18,2012-05-04,The Avengers 2012,225000000,623279547,1517935897,894656350,1292935897,2012,"Action,Adventure,Sci-Fi",Joss Whedon,177.01313199999998,297.6250444444445,574.6381764444444
19,2013-06-14,Man of Steel 2013,225000000,291045518,667999518,376954000,442999518,2013,"Action,Adventure,Sci-Fi",Zack Snyder,29.353563555555557,67.5351111111111,196.88867466666667
20,2012-07-03,The Amazing Spider-Man 2012,220000000,262030663,757890267,495859604,537890267,2012,"Action,Adventure,Sci-Fi",Marc Webb,19.104846818181816,125.39072909090909,244.4955759090909
21,2012-05-18,Battleship 2012,220000000,65233400,313477717,248244317,93477717,2012,"Action,Adventure,Sci-Fi",Peter Berg,-70.34845454545454,12.838325909090909,42.48987136363636
22,2017-06-21,Transformers: The Last Knight 2017,217000000,130168683,602893340,472724657,385893340,2017,"Action,Adventure,Sci-Fi",Michael Bay,-40.01443179723502,117.84546405529954,177.8310322580645
23,2015-06-12,Jurassic World 2015,215000000,652270625,1648854864,996584239,1433854864,2015,"Action,Adventure,Sci-Fi",Colin Trevorrow,203.38168604651165,363.52755302325585,666.9092390697674
24,2012-05-25,Men in Black 3 2012,215000000,179020854,654213485,475192631,439213485,2012,"Action,Adventure,Comedy",Barry Sonnenfeld,-16.734486511627907,121.01982837209302,204.2853418604651
25,2014-06-27,Transformers: Age of Extinction 2014,210000000,245439076,1104039076,858600000,894039076,2014,"Action,Adventure,Sci-Fi",Michael Bay,16.875750476190476,308.85714285714283,425.7328933333333
27,2018-02-16,Black Panther 2018,200000000,700059566,1348258224,648198658,1148258224,2018,"Action,Adventure,Sci-Fi",Ryan Coogler,250.029783,224.099329,574.129112
28,2018-06-15,Incredibles 2 2018,200000000,608581744,1242520711,633938967,1042520711,2018,"Action,Adventure,Animation",Brad Bird,204.29087199999998,216.9694835,521.2603555000001
29,2016-12-16,Rogue One: A Star Wars Story 2016,200000000,532177324,1049102856,516925532,849102856,2016,"Action,Adventure,Sci-Fi",Gareth Edwards,166.088662,158.462766,424.551428
30,2016-06-17,Finding Dory 2016,200000000,486295561,1021215193,534919632,821215193,2016,"Adventure,Animation,Comedy","Andrew Stanton, Angus MacLane",143.1477805,167.459816,410.60759649999994
32,2013-05-03,Iron Man 3 2013,200000000,408992272,1215392272,806400000,1015392272,2013,"Action,Adventure,Sci-Fi",Shane Black,104.496136,303.2,507.696136
35,2012-11-08,Skyfall 2012,200000000,304360277,1110526981,806166704,910526981,2012,"Action,Adventure,Thriller",Sam Mendes,52.1801385,303.083352,455.2634905
36,2013-06-21,Monsters University 2013,200000000,268488329,743588329,475100000,543588329,2013,"Adventure,Animation,Comedy",Dan Scanlon,34.244164500000004,137.54999999999998,271.79416449999997
37,2013-03-08,Oz the Great and Powerful 2013,200000000,234770996,490359051,255588055,290359051,2013,"Adventure,Family,Fantasy",Sam Raimi,17.385498,27.794027500000002,145.17952549999998
38,2014-05-23,X-Men: Days of Future Past 2014,200000000,233921534,747862775,513941241,547862775,2014,"Action,Adventure,Sci-Fi",Bryan Singer,16.960766999999997,156.9706205,273.9313875
39,2014-05-02,The Amazing Spider-Man 2 2014,200000000,202853933,708996336,506142403,508996336,2014,"Action,Adventure,Sci-Fi",Marc Webb,1.4269665,153.0712015,254.498168
40,2011-06-24,Cars 2 2011,200000000,191450875,560155383,368704508,360155383,2011,"Adventure,Animation,Comedy","Bradford Lewis, John Lasseter",-4.2745625,84.352254,180.0776915
41,2018-11-16,Fantastic Beasts: The Crimes of Grindelwald 2018,200000000,159555901,652220086,492664185,452220086,2018,"Adventure,Family,Fantasy",David Yates,-20.2220495,146.33209250000002,226.110043
42,2011-06-17,Green Lantern 2011,200000000,116601172,219535492,102934320,19535492,2011,"Action,Adventure,Sci-Fi",Martin Campbell,-41.699414000000004,-48.53284,9.767745999999999
43,2011-06-29,Transformers: Dark of the Moon 2011,195000000,352390543,1123790543,771400000,928790543,2011,"Action,Adventure,Sci-Fi",Michael Bay,80.71309897435897,295.5897435897436,476.3028425641026
44,2017-06-09,The Mummy 2017,195000000,80101125,409953905,329852780,214953905,2017,"Action,Adventure,Fantasy",Alex Kurtzman,-58.9225,69.1552717948718,110.23277179487178
45,2013-03-01,Jack the Giant Slayer 2013,195000000,65187603,197687603,132500000,2687603,2013,"Adventure,Fantasy",Bryan Singer,-66.57046,-32.05128205128205,1.3782579487179487
46,2015-04-03,Furious 7 2015,190000000,353007020,1518722794,1165715774,1328722794,2015,"Action,Crime,Thriller",James Wan,85.79316842105264,513.5346178947368,699.3277863157895
47,2013-05-16,Star Trek Into Darkness 2013,190000000,228778661,467381584,238602923,277381584,2013,"Action,Adventure,Sci-Fi",J.J. Abrams,20.40982157894737,25.580485789473684,145.99030736842104
48,2013-06-21,World War Z 2013,190000000,202359711,531514650,329154939,341514650,2013,"Action,Adventure,Horror",Marc Forster,6.505111052631579,73.23944157894738,179.74455263157896
49,2013-05-10,The Great Gatsby 2013,190000000,144840419,351040419,206200000,161040419,2013,"Drama,Romance",Baz Luhrmann,-23.768200526315788,8.526315789473685,84.75811526315789
50,2013-07-12,Pacific Rim 2013,190000000,101802906,411002906,309200000,221002906,2013,"Action,Adventure,Sci-Fi",Guillermo del Toro,-46.41952315789474,62.73684210526316,116.31731894736843
51,2015-11-25,The Good Dinosaur 2015,187500000,123087120,333771037,210683917,146271037,2015,"Adventure,Animation,Comedy",Peter Sohn,-34.353536,12.364755733333334,78.01121973333333
52,2012-06-22,Brave 2012,185000000,237282182,554606532,317324350,369606532,2012,"Adventure,Animation,Comedy","Brenda Chapman, Steve Purcell, Mark Andrews",28.260638918918918,71.52667567567568,199.7873145945946
53,2017-03-10,Kong: Skull Island 2017,185000000,168052812,561072059,393019247,376072059,2017,"Action,Adventure,Fantasy",Jordan Vogt-Roberts,-9.160642162162162,112.44283621621622,203.28219405405403
54,2016-07-22,Star Trek Beyond 2016,185000000,158848340,335802233,176953893,150802233,2016,"Action,Adventure,Sci-Fi",Justin Lin,-14.136032432432433,-4.349247027027027,81.51472054054054
55,2017-10-06,Blade Runner 2049 2017,185000000,92054159,259357408,167303249,74357408,2017,"Drama,Mystery,Sci-Fi",Denis Villeneuve,-50.24099513513514,-9.565811351351352,40.19319351351351
56,2019-05-24,Aladdin 2019,182000000,246734314,619234314,372500000,437234314,2019,"Adventure,Comedy,Family",Guy Ritchie,35.56830439560439,104.67032967032968,240.23863406593406
57,2017-11-03,Thor: Ragnarok 2017,180000000,315058289,846980024,531921735,666980024,2017,"Action,Adventure,Comedy",Taika Waititi,75.03238277777777,195.512075,370.5444577777778
58,2014-05-30,Maleficent 2014,180000000,241407328,758536735,517129407,578536735,2014,"Action,Adventure,Family",Robert Stromberg,34.115182222222224,187.294115,321.4092972222222
59,2016-11-18,Fantastic Beasts and Where to Find Them 2016,180000000,234037575,802402853,568365278,622402853,2016,"Adventure,Family,Fantasy",David Yates,30.020875000000004,215.7584877777778,345.7793627777778
60,2016-07-01,The Legend of Tarzan 2016,180000000,126643061,348902025,222258964,168902025,2016,"Action,Adventure,Drama",David Yates,-29.64274388888889,23.47720222222222,93.83445833333333
61,2011-11-23,Hugo 2011,180000000,73864507,180047784,106183277,47784,2011,"Adventure,Drama,Family",Martin Scorsese,-58.96416277777777,-41.00929055555555,0.026546666666666666
62,2017-07-21,Valerian and the City of a Thousand Planets 2017,180000000,40479370,215098356,174618986,35098356,2017,"Action,Adventure,Fantasy",Luc Besson,-77.51146111111112,-2.9894522222222224,19.499086666666667
63,2015-02-06,Jupiter Ascending 2015,179000000,47482519,181982519,134500000,2982519,2015,"Action,Adventure,Sci-Fi","Lilly Wachowski, Lana Wachowski",-73.47345307262569,-24.860335195530723,1.6662117318435754
64,2016-05-27,X-Men: Apocalypse 2016,178000000,155442489,542537546,387095057,364537546,2016,"Action,Adventure,Sci-Fi",Bryan Singer,-12.672758988764047,117.46913314606742,204.79637415730338
65,2018-08-10,The Meg 2018,178000000,145443742,529530715,384086973,351530715,2018,"Action,Horror,Sci-Fi",Jon Turteltaub,-18.290032584269664,115.77919831460675,197.48916573033708
66,2014-06-06,Edge of Tomorrow 2014,178000000,100206256,370541256,270335000,192541256,2014,"Action,Sci-Fi",Doug Liman,-43.70435056179775,51.87359550561798,108.16924494382023
67,2019-03-08,Captain Marvel 2019,175000000,426525952,1123061550,696535598,948061550,2019,"Action,Adventure,Sci-Fi","Ryan Fleck, Anna Boden",143.72911542857142,298.02034171428573,541.7494571428572
68,2016-04-15,The Jungle Book 2016,175000000,364001123,962854547,598853424,787854547,2016,"Adventure,Drama,Family",Jon Favreau,108.00064171428572,242.20195657142858,450.2025982857143
69,2015-06-19,Inside Out 2015,175000000,356461711,854235992,497774281,679235992,2015,"Adventure,Animation,Comedy","Pete Docter, Ronnie Del Carmen",103.69240628571428,184.44244628571428,388.1348525714286
70,2017-07-07,Spider-Man: Homecoming 2017,175000000,334201140,880166350,545965210,705166350,2017,"Action,Adventure,Sci-Fi",Jon Watts,90.97208,211.98012,402.9522
71,2016-08-05,Suicide Squad 2016,175000000,325100054,746059887,420959833,571059887,2016,"Action,Adventure,Fantasy",David Ayer,85.77145942857143,140.548476,326.31993542857145
72,2017-11-22,Coco 2017,175000000,209726015,798008101,588282086,623008101,2017,"Adventure,Animation,Comedy","Lee Unkrich, Adrian Molina",19.84343714285714,236.161192,356.00462914285714
74,2017-06-16,Cars 3 2017,175000000,152901115,383541369,230640254,208541369,2017,"Adventure,Animation,Comedy",Brian Fee,-12.627934285714284,31.794430857142856,119.16649657142857
75,2017-05-12,King Arthur: Legend of the Sword 2017,175000000,39175066,139630336,100455270,-35369664,2017,"Action,Adventure,Drama",Guy Ritchie,-77.614248,-42.596988571428575,-20.21123657142857
76,2013-12-25,47 Ronin 2013,175000000,38362475,151716815,113354340,-23283185,2013,"Action,Adventure,Drama",Carl Rinsch,-78.07858571428572,-35.22609142857143,-13.304677142857143
77,2018-06-22,Jurassic World: Fallen Kingdom 2018,170000000,417719760,1305772799,888053039,1135772799,2018,"Action,Adventure,Sci-Fi",J.A. Bayona,145.71750588235295,422.38414058823525,668.1016464705882
78,2014-08-01,Guardians of the Galaxy 2014,170000000,333172112,770867516,437695404,600867516,2014,"Action,Adventure,Comedy",James Gunn,95.98359529411765,157.46788470588234,353.45148
80,2014-04-04,Captain America: The Winter Soldier 2014,170000000,259746958,714401889,454654931,544401889,2014,"Action,Adventure,Sci-Fi","Anthony Russo, Joe Russo",52.792328235294114,167.44407705882352,320.2364052941177
81,2014-07-11,Dawn of the Planet of the Apes 2014,170000000,208545589,710644566,502098977,540644566,2014,"Action,Adventure,Drama",Matt Reeves,22.67387588235294,195.35233941176472,318.02621529411766
82,2012-06-01,Snow White and the Huntsman 2012,170000000,155136755,401021746,245884991,231021746,2012,"Action,Adventure,Drama",Rupert Sanders,-8.743085294117648,44.63823,135.89514470588236
83,2019-03-29,Dumbo 2019,170000000,113883318,345004422,231121104,175004422,2019,"Adventure,Family,Fantasy",Tim Burton,-33.00981294117647,35.95359058823529,102.94377764705882
84,2015-05-22,Tomorrowland 2015,170000000,93436322,206627518,113191196,36627518,2015,"Action,Adventure,Family",Brad Bird,-45.03745764705883,-33.41694352941176,21.54559882352941
85,2019-02-14,Alita: Battle Angel 2019,170000000,85710210,402976036,317265826,232976036,2019,"Action,Adventure,Sci-Fi",Robert Rodriguez,-49.58222941176471,86.62695647058824,137.04472705882353
86,2019-05-31,Godzilla: King of the Monsters 2019,170000000,85576941,299276941,213700000,129276941,2019,"Action,Adventure,Fantasy",Michael Dougherty,-49.66062294117647,25.705882352941178,76.0452594117647
87,2016-05-27,Alice Through the Looking Glass 2016,170000000,77042381,276928112,199885731,106928112,2016,"Adventure,Family,Fantasy",James Bobin,-54.68095235294118,17.579841764705883,62.8988894117647
89,2016-11-04,Doctor Strange 2016,165000000,232641920,676404566,443762646,511404566,2016,"Action,Adventure,Fantasy",Scott Derrickson,40.995103030303035,168.9470581818182,309.94216121212116
90,2014-11-07,Big Hero 6 2014,165000000,222527828,652127828,429600000,487127828,2014,"Action,Adventure,Animation","Don Hall, Chris Williams",34.865350303030304,160.36363636363635,295.2289866666667
92,2012-11-02,Wreck-It Ralph 2012,165000000,189412677,496511521,307098844,331511521,2012,"Adventure,Animation,Comedy",Rich Moore,14.795561818181818,86.1205115151515,200.91607333333332
93,2014-11-05,Interstellar 2014,165000000,188017894,666379375,478361481,501379375,2014,"Adventure,Drama,Sci-Fi",Christopher Nolan,13.950238787878789,189.9160490909091,303.8662878787879
94,2016-06-24,Independence Day: Resurgence 2016,165000000,103144286,384169424,281025138,219169424,2016,"Action,Adventure,Sci-Fi",Roland Emmerich,-37.488311515151516,70.31826545454545,132.82995393939393
95,2017-03-17,Beauty and the Beast 2017,160000000,504014165,1259199706,755185541,1099199706,2017,"Family,Fantasy,Musical",Bill Condon,215.00885312500003,371.990963125,686.99981625
96,2018-12-21,Aquaman 2018,160000000,335061807,1146894640,811832833,986894640,2018,"Action,Adventure,Fantasy",James Wan,109.41362937500001,407.395520625,616.80915
98,2015-11-20,The Hunger Games: Mockingjay - Part 2 2015,160000000,281723902,648986787,367262885,488986787,2015,"Action,Adventure,Sci-Fi",Francis Lawrence,76.07743875,129.539303125,305.616741875
99,2014-05-16,Godzilla 2014,160000000,200676069,529076069,328400000,369076069,2014,"Action,Adventure,Sci-Fi",Gareth Edwards,25.422543125,105.25,230.67254312499998
100,2011-06-03,X-Men: First Class 2011,160000000,146408305,355408305,209000000,195408305,2011,"Action,Adventure,Sci-Fi",Matthew Vaughn,-8.494809374999999,30.625000000000004,122.13019062499998
102,2016-06-10,Warcraft 2016,160000000,47225655,425522281,378296626,265522281,2016,"Action,Adventure,Fantasy",Duncan Jones,-70.483965625,136.43539124999998,165.951425625
103,2016-09-30,Deepwater Horizon 2016,156000000,61433527,122603824,61170297,-33396176,2016,"Action,Drama,History",Peter Berg,-60.61953397435897,-60.78827115384615,-21.40780512820513
105,2018-03-23,Pacific Rim: Uprising 2018,155000000,59874525,290930148,231055623,135930148,2018,"Action,Adventure,Sci-Fi",Steven S. DeKnight,-61.37127419354839,49.06814387096774,87.69686967741936
106,2017-07-14,War for the Planet of the Apes 2017,152000000,146880162,489592267,342712105,337592267,2017,"Action,Adventure,Drama",Matt Reeves,-3.3683144736842108,125.46849013157895,222.10017565789474
107,2017-06-02,Wonder Woman 2017,150000000,412563408,821133378,408569970,671133378,2017,"Action,Adventure,Fantasy",Patty Jenkins,175.042272,172.37998000000002,447.42225199999996
108,2013-11-22,Frozen 2013,150000000,400738009,1272469910,871731901,1122469910,2013,"Adventure,Animation,Comedy","Chris Buck, Jennifer Lee",167.15867266666666,481.15460066666674,748.3132733333333
109,2016-03-04,Zootopia 2016,150000000,341268248,1019429616,678161368,869429616,2016,"Adventure,Animation,Comedy","Byron Howard, Rich Moore, Jared Bush",127.51216533333334,352.10757866666665,579.6197440000001
110,2016-11-23,Moana 2016,150000000,248757044,637517365,388760321,487517365,2016,"Adventure,Animation,Comedy","Don Hall, Chris Williams, Ron Clements, John Musker",65.83802933333334,159.17354733333332,325.01157666666666
111,2013-11-08,Thor: The Dark World 2013,150000000,206362140,644602516,438240376,494602516,2013,"Action,Adventure,Fantasy",Alan Taylor,37.574760000000005,192.16025066666666,329.7350106666667
112,2017-07-21,Dunkirk 2017,150000000,190068280,499837368,309769088,349837368,2017,"Action,Drama,History",Christopher Nolan,26.712186666666664,106.51272533333334,233.22491200000002
113,2011-05-06,Thor 2011,150000000,181030624,449326618,268295994,299326618,2011,"Action,Adventure,Fantasy",Kenneth Branagh,20.68708266666667,78.863996,199.55107866666665
114,2011-05-26,Kung Fu Panda 2 2011,150000000,165249063,664837547,499588484,514837547,2011,"Action,Adventure,Animation",Jennifer Yuh Nelson,10.166042000000001,233.05898933333333,343.22503133333333
115,2015-05-15,Mad Max: Fury Road 2015,150000000,153636354,370098020,216461666,220098020,2015,"Action,Adventure,Sci-Fi",George Miller,2.424236,44.307777333333334,146.73201333333336
116,2018-03-29,Ready Player One 2018,150000000,137690172,579290136,441599964,429290136,2018,"Action,Adventure,Sci-Fi",Steven Spielberg,-8.206552,194.399976,286.193424
118,2012-03-30,Wrath of the Titans 2012,150000000,83670083,305270083,221600000,155270083,2012,"Action,Adventure,Fantasy",Jonathan Liebesman,-44.21994466666666,47.733333333333334,103.51338866666666
119,2012-05-11,Dark Shadows 2012,150000000,79727149,238202668,158475519,88202668,2012,"Comedy,Fantasy,Horror",Tim Burton,-46.848567333333335,5.650346,58.80177866666667
120,2013-06-28,White House Down 2013,150000000,73103784,205440387,132336603,55440387,2013,"Action,Drama,Thriller",Roland Emmerich,-51.264144,-11.775598,36.960258
122,2017-02-17,The Great Wall 2017,150000000,45157105,334486852,289329747,184486852,2017,Documentary,Tadhg O'Sullivan,-69.89526333333333,92.88649799999999,122.99123466666666
123,2015-10-09,Pan 2015,150000000,35088320,151525973,116437653,1525973,2015,"Adventure,Comedy,Family",Joe Wright,-76.60778666666667,-22.374897999999998,1.0173153333333333
124,2011-03-11,Mars Needs Moms 2011,150000000,21392758,39549758,18157000,-110450242,2011,"Adventure,Animation,Family",Simon Wells,-85.73816133333332,-87.89533333333334,-73.63349466666666
125,2012-06-08,Madagascar 3: Europe's Most Wanted 2012,145000000,216391482,746921271,530529789,601921271,2012,"Adventure,Animation,Comedy","Tom McGrath, Conrad Vernon, Eric Darnell",49.235504827586205,265.88261310344825,415.1181179310345
126,2014-06-13,How to Train Your Dragon 2 2014,145000000,177002924,614586270,437583346,469586270,2014,"Action,Adventure,Animation",Dean DeBlois,22.070982068965517,201.78161793103448,323.8526
127,2014-03-07,Mr. Peabody & Sherman 2014,145000000,111506430,269806430,158300000,124806430,2014,"Adventure,Animation,Comedy",Rob Minkoff,-23.09901379310345,9.172413793103448,86.0734
128,2012-11-21,Rise of the Guardians 2012,145000000,103412758,306900902,203488144,161900902,2012,"Action,Adventure,Animation",Peter Ramsey,-28.680856551724137,40.336651034482756,111.65579448275862
129,2016-07-15,Ghostbusters 2016,144000000,128350574,229008658,100658084,85008658,2016,"Action,Comedy,Fantasy",Paul Feig,-10.867656944444445,-30.098552777777776,59.033790277777776
130,2011-07-22,Captain America: The First Avenger 2011,140000000,176654505,370569776,193915271,230569776,2011,"Action,Adventure,Sci-Fi",Joe Johnston,26.181789285714284,38.510907857142854,164.69269714285716
131,2016-01-29,Kung Fu Panda 3 2016,140000000,143528619,517599142,374070523,377599142,2016,"Action,Adventure,Animation","Jennifer Yuh Nelson, Alessandro Carloni",2.520442142857143,167.1932307142857,269.71367285714285
132,2013-03-27,G.I. Joe: Retaliation 2013,140000000,122523060,375740705,253217645,235740705,2013,"Action,Adventure,Sci-Fi",Jon M. Chu,-12.483528571428572,80.86974642857143,168.38621785714284
133,2014-12-12,Exodus: Gods and Kings 2014,140000000,65014513,268314513,203300000,128314513,2014,"Action,Adventure,Drama",Ridley Scott,-53.56106214285714,45.214285714285715,91.65322357142857
134,2016-07-01,The BFG 2016,140000000,55483770,199646680,144162910,59646680,2016,"Adventure,Family,Fantasy",Steven Spielberg,-60.36873571428571,2.973507142857143,42.60477142857143
135,2016-02-26,Gods of Egypt 2016,140000000,31153464,138836756,107683292,-1163244,2016,"Action,Adventure,Fantasy",Alex Proyas,-77.74752571428571,-23.08336285714286,-0.8308885714285714
136,2013-03-22,The Croods 2013,135000000,187168425,573068425,385900000,438068425,2013,"Action,Adventure,Animation","Chris Sanders, Kirk DeMicco",38.643277777777776,185.85185185185185,324.4951296296296
137,2015-12-25,The Revenant 2015,135000000,183637894,532938302,349300408,397938302,2015,"Action,Adventure,Biography",Alejandro G. IÃ±Ã¡rritu,36.02806962962963,158.74104296296295,294.7691125925926
138,2011-03-04,Rango 2011,135000000,123477607,245724600,122246993,110724600,2011,"Adventure,Animation,Comedy",Gore Verbinski,-8.535105925925926,-9.446671851851853,82.01822222222222
139,2013-07-17,Turbo 2013,135000000,83028130,286896578,203868448,151896578,2013,"Adventure,Animation,Comedy",David Soren,-38.497681481481486,51.01366518518519,112.51598370370371
140,2016-06-03,Teenage Mutant Ninja Turtles: Out of the Shadows 2016,135000000,82051601,245328374,163276773,110328374,2016,"Action,Adventure,Comedy",Dave Green,-39.2210362962963,20.945757777777775,81.72472148148148
141,2011-11-18,Happy Feet Two 2011,135000000,64006466,157956466,93950000,22956466,2011,"Adventure,Animation,Comedy","George Miller, Gary Eck, David Peers",-52.58780296296296,-30.407407407407405,17.00478962962963
142,2018-11-02,The Nutcracker and the Four Realms 2018,132900000,54858851,170293899,115435048,37393899,2018,"Adventure,Family,Fantasy","Joe Johnston, Lasse HallstrÃ¶m",-58.72170729872084,-13.141423626787057,28.1368690744921
143,2014-11-26,Penguins of Madagascar 2014,132000000,83350911,366942531,283591620,234942531,2014,"Adventure,Animation,Comedy","Eric Darnell, Simon J. Smith",-36.85537045454546,114.84213636363636,177.9867659090909
144,2013-11-22,The Hunger Games: Catching Fire 2013,130000000,424668047,864868047,440200000,734868047,2013,"Action,Adventure,Sci-Fi",Francis Lawrence,226.66772846153847,238.61538461538464,565.2831130769231
145,2018-07-06,Ant-Man and the Wasp 2018,130000000,216648740,623144660,406495920,493144660,2018,"Action,Adventure,Comedy",Peyton Reed,66.65287692307692,212.6891692307692,379.3420461538461
146,2015-07-17,Ant-Man 2015,130000000,180202163,518858449,338656286,388858449,2015,"Action,Adventure,Comedy",Peyton Reed,38.61704846153846,160.50483538461538,299.1218838461538
147,2015-03-27,Home 2015,130000000,177397510,385997896,208600386,255997896,2015,"Adventure,Animation,Comedy",Tim Johnson,36.45962307692307,60.461835384615384,196.92145846153846
151,2018-12-19,Mary Poppins Returns 2018,130000000,171958438,341528518,169570080,211528518,2018,"Comedy,Family,Fantasy",Rob Marshall,32.27572153846154,30.43852307692308,162.71424461538462
152,2011-10-28,Puss in Boots 2011,130000000,149260504,554987477,405726973,424987477,2011,"Action,Adventure,Animation",Chris Miller,14.815772307692306,212.09767153846153,326.9134438461538
154,2014-04-11,Rio 2 2014,130000000,131538435,492846291,361307856,362846291,2014,"Adventure,Animation,Comedy",Carlos Saldanha,1.1834115384615385,177.92912,279.11253153846155
156,2014-03-28,Noah 2014,130000000,101200044,352831065,251631021,222831065,2014,"Action,Adventure,Drama",Darren Aronofsky,-22.15381230769231,93.56232384615384,171.40851153846154
157,2011-12-21,The Adventures of Tintin 2011,130000000,77591831,373993951,296402120,243993951,2011,"Action,Adventure,Animation",Steven Spielberg,-40.313976153846156,128.00163076923076,187.68765461538462
158,2013-05-31,After Earth 2013,130000000,60522097,251499665,190977568,121499665,2013,"Action,Adventure,Drama",M. Night Shyamalan,-53.44454076923076,46.90582153846154,93.46128076923077
159,2013-07-19,R.I.P.D. 2013,130000000,33618855,79076678,45457823,-50923322,2013,"Action,Adventure,Comedy",Robert Schwentke,-74.13934230769232,-65.03244384615384,-39.171786153846156
160,2019-02-22,How to Train Your Dragon: The Hidden World 2019,129000000,160791800,519258283,358466483,390258283,2019,"Action,Adventure,Animation",Dean DeBlois,24.644806201550388,177.88099457364342,302.52580077519383
161,2017-03-03,Logan 2017,127000000,226277068,615461394,389184326,488461394,2017,"Action,Drama,Sci-Fi",James Mangold,78.17091968503938,206.44435118110235,384.6152708661417
162,2014-12-19,Night at the Museum: Secret of the Tomb 2014,127000000,113746621,353756621,240010000,226756621,2014,"Adventure,Comedy,Family",Shawn Levy,-10.435731496062992,88.98425196850394,178.54852047244094
163,2014-11-21,The Hunger Games: Mockingjay - Part 1 2014,125000000,337135885,766575131,429439246,641575131,2014,"Action,Adventure,Sci-Fi",Francis Lawrence,169.708708,243.5513968,513.2601048
164,2011-04-29,Fast Five 2011,125000000,210031325,630163454,420132129,505163454,2011,"Action,Crime,Thriller",Justin Lin,68.02506000000001,236.10570320000002,404.1307632
165,2014-08-08,Teenage Mutant Ninja Turtles 2014,125000000,191204754,485004754,293800000,360004754,2014,"Action,Adventure,Comedy",Jonathan Liebesman,52.9638032,135.04,288.0038032
166,2011-12-16,Sherlock Holmes: A Game of Shadows 2011,125000000,186848418,535663443,348815025,410663443,2011,"Action,Adventure,Crime",Guy Ritchie,49.4787344,179.05202,328.53075440000003
167,2017-03-31,The Boss Baby 2017,125000000,175003033,510878762,335875729,385878762,2017,"Adventure,Animation,Comedy",Tom McGrath,40.002426400000004,168.7005832,308.7030096
169,2016-11-04,Trolls 2016,125000000,153707064,344150134,190443070,219150134,2016,"Adventure,Animation,Comedy","Mike Mitchell, Walt Dohrn",22.9656512,52.354456000000006,175.3201072
170,2012-06-08,Prometheus 2012,125000000,126477084,402448265,275971181,277448265,2012,"Adventure,Mystery,Sci-Fi",Ridley Scott,1.1816672000000001,120.77694480000001,221.95861200000002
171,2012-08-10,The Bourne Legacy 2012,125000000,113203870,280355920,167152050,155355920,2012,"Action,Adventure,Thriller",Tony Gilroy,-9.436904,33.72164,124.28473600000001
172,2018-07-13,Skyscraper 2018,125000000,68420120,304115534,235695414,179115534,2018,"Action,Adventure,Thriller",Rawson Marshall Thurber,-45.263904,88.5563312,143.2924272
173,2012-08-03,Total Recall 2012,125000000,58877969,211856088,152978119,86856088,2012,"Action,Adventure,Mystery",Len Wiseman,-52.897624799999996,22.3824952,69.4848704
174,2016-07-29,Jason Bourne 2016,120000000,162192920,416168316,253975396,296168316,2016,"Action,Thriller",Paul Greengrass,35.16076666666667,111.64616333333332,246.80692999999997
175,2012-11-21,Life of Pi 2012,120000000,124987022,620912003,495924981,500912003,2012,"Adventure,Drama,Fantasy",Ang Lee,4.155851666666667,313.27081749999996,417.42666916666667
176,2018-04-13,Rampage 2018,120000000,101028233,428056280,327028047,308056280,2018,"Action,Adventure,Sci-Fi",Brad Peyton,-15.809805833333336,172.5233725,256.7135666666667
177,2013-08-09,Elysium 2013,120000000,93050117,286192091,193141974,166192091,2013,"Action,Drama,Sci-Fi",Neill Blomkamp,-22.458235833333333,60.951645,138.49340916666665
178,2013-04-19,Oblivion 2013,120000000,89107235,287916633,198809398,167916633,2013,"Action,Adventure,Sci-Fi",Joseph Kosinski,-25.743970833333336,65.67449833333333,139.93052749999998
179,2017-03-24,Power Rangers 2017,120000000,85364450,142531552,57167102,22531552,2017,"Action,Adventure,Sci-Fi",Dean Israelite,-28.86295833333333,-52.360748333333326,18.77629333333333
180,2014-02-12,RoboCop 2014,120000000,58607007,242981799,184374792,122981799,2014,"Action,Crime,Sci-Fi",JosÃ© Padilha,-51.160827499999996,53.64565999999999,102.4848325
181,2015-08-07,Fantastic Four 2015,120000000,56117548,167849187,111731639,47849187,2015,"Action,Adventure,Drama",Josh Trank,-53.23537666666667,-6.890300833333334,39.8743225
183,2018-10-05,Venom 2018,116000000,213511408,853628605,640117197,737628605,2018,"Action,Sci-Fi,Thriller",Ruben Fleischer,84.06155862068965,451.82516982758625,635.8867284482758
184,2013-07-26,The Wolverine 2013,115000000,132556852,416456852,283900000,301456852,2013,"Action,Adventure,Sci-Fi",James Mangold,15.266827826086956,146.86956521739128,262.1363930434783
186,2017-12-15,Ferdinand 2017,111000000,84410380,289847930,205437550,178847930,2017,"Adventure,Animation,Comedy",Carlos Saldanha,-23.954612612612614,85.07887387387387,161.12426126126127
187,2018-05-18,Deadpool 2 2018,110000000,324591735,786680557,462088822,676680557,2018,"Action,Adventure,Comedy",David Leitch,195.08339545454544,320.08074727272725,615.1641427272727
188,2013-10-04,Gravity 2013,110000000,274092705,693698673,419605968,583698673,2013,"Drama,Sci-Fi,Thriller",Alfonso CuarÃ³n,149.17518636363636,281.4599709090909,530.6351572727273
189,2015-05-29,San Andreas 2015,110000000,155190832,456258539,301067707,346258539,2015,"Action,Adventure,Drama",Brad Peyton,41.08257454545455,173.69791545454544,314.78049
190,2011-07-29,The Smurfs 2011,110000000,142614158,563749323,421135165,453749323,2011,"Adventure,Animation,Comedy",Raja Gosnell,29.649234545454544,282.85015,412.4993845454545
191,2014-03-07,300: Rise of an Empire 2014,110000000,106580051,330780051,224200000,220780051,2014,"Action,Fantasy,War",Noam Murro,-3.1090445454545454,103.81818181818181,200.70913727272725
192,2016-12-21,Passengers 2016,110000000,100014699,302239672,202224973,192239672,2016,"Drama,Romance,Sci-Fi",Morten Tyldum,-9.077546363636364,83.84088454545454,174.76333818181817
193,2011-01-14,The Green Hornet 2011,110000000,98780042,229155503,130375461,119155503,2011,"Action,Comedy,Crime",Michel Gondry,-10.19996181818182,18.523146363636364,108.32318454545455
194,2011-10-07,Real Steel 2011,110000000,85463309,263880341,178417032,153880341,2011,"Action,Drama,Family",Shawn Levy,-22.306082727272727,62.19730181818181,139.8912190909091
196,2013-07-31,The Smurfs 2 2013,110000000,71017784,348547523,277529739,238547523,2013,"Adventure,Animation,Comedy",Raja Gosnell,-35.43837818181818,152.29976272727274,216.86138454545457
197,2013-11-01,Ender's Game 2013,110000000,61737191,127983283,66246092,17983283,2013,"Action,Adventure,Fantasy",Gavin Hood,-43.87528090909091,-39.77628,16.348439090909093
198,2017-03-31,Ghost in the Shell 2017,110000000,40563557,167910690,127347133,57910690,2017,"Action,Drama,Sci-Fi",Rupert Sanders,-63.12403909090909,15.77012090909091,52.64608181818182
199,2019-06-14,Men in Black: International 2019,110000000,3100000,3100000,0,-106900000,2019,"Action,Adventure,Comedy",F. Gary Gray,-97.18181818181819,-100.0,-97.18181818181819
200,2015-10-02,The Martian 2015,108000000,228433663,655271443,426837780,547271443,2015,"Adventure,Drama,Sci-Fi",Ridley Scott,111.51265092592593,295.22016666666667,506.7328175925926
201,2016-11-23,Allied 2016,106000000,40098064,119266661,79168597,13266661,2016,"Action,Drama,Romance",Robert Zemeckis,-62.17163773584906,-25.312644339622643,12.515717924528303
202,2016-07-22,Ice Age: Collision Course 2016,105000000,64063008,402156682,338093674,297156682,2016,"Adventure,Animation,Comedy","Mike Thurmeier, Galen T. Chu",-38.98761142857143,221.99397523809523,283.0063638095238
203,2017-09-22,Kingsman: The Golden Circle 2017,104000000,100234838,408803696,308568858,304803696,2017,"Action,Adventure,Comedy",Matthew Vaughn,-3.620348076923077,196.70082499999998,293.0804769230769
204,2018-03-09,A Wrinkle in Time 2018,103000000,100478608,133401882,32923274,30401882,2018,"Adventure,Family,Fantasy",Ava DuVernay,-2.447953398058252,-68.03565631067961,29.516390291262134
205,2018-12-21,Bumblebee 2018,102000000,127195589,465195589,338000000,363195589,2018,"Action,Adventure,Sci-Fi",Travis Knight,24.701557843137255,231.37254901960787,356.0741068627451
206,2012-10-26,Cloud Atlas 2012,102000000,27108272,130673154,103564882,28673154,2012,"Action,Drama,Mystery","Lilly Wachowski, Lana Wachowski, Tom Tykwer",-73.42326274509804,1.5341980392156862,28.110935294117645
207,2012-12-25,Django Unchained 2012,100000000,162805434,449948323,287142889,349948323,2012,"Drama,Western",Quentin Tarantino,62.805434000000005,187.142889,349.948323
210,2013-12-25,The Wolf of Wall Street 2013,100000000,116900694,389870414,272969720,289870414,2013,"Biography,Crime,Drama",Martin Scorsese,16.900693999999998,172.96972,289.870414
211,2013-05-24,Epic 2013,100000000,107518682,262794441,155275759,162794441,2013,"Adventure,Animation,Family",Chris Wedge,7.518682,55.275759,162.794441
212,2012-08-17,The Expendables 2 2012,100000000,85028192,311979256,226951064,211979256,2012,"Action,Adventure,Thriller",Simon West,-14.971808000000001,126.951064,211.979256
213,2014-07-25,Hercules 2014,100000000,72688614,243388614,170700000,143388614,2014,"Action,Adventure,Fantasy",Brett Ratner,-27.311386,70.7,143.388614
217,2019-03-15,Wonder Park 2019,100000000,45216793,115149422,69932629,15149422,2019,"Adventure,Animation,Comedy",Dylan Brown,-54.783207,-30.067370999999998,15.149422000000001
218,2014-08-15,The Expendables 3 2014,100000000,39322544,209461378,170138834,109461378,2014,"Action,Adventure,Thriller",Patrick Hughes,-60.677456,70.138834,109.461378
220,2017-10-20,Geostorm 2017,100000000,33700160,220796009,187095849,120796009,2017,"Action,Sci-Fi,Thriller",Dean Devlin,-66.29984,87.095849,120.796009
221,2015-12-25,Point Break 2015,100000000,28782481,126704591,97922110,26704591,2015,"Action,Crime,Sport",Ericson Core,-71.217519,-2.07789,26.704591
222,2015-12-11,In the Heart of the Sea 2015,100000000,25020758,89693309,64672551,-10306691,2015,"Action,Adventure,Biography",Ron Howard,-74.979242,-35.327449,-10.306690999999999
223,2014-04-18,Transcendence 2014,100000000,23022309,103039258,80016949,3039258,2014,"Action,Drama,Sci-Fi",Wally Pfister,-76.97769100000001,-19.983051,3.039258
224,2018-12-14,Mortal Engines 2018,100000000,15951040,85287417,69336377,-14712583,2018,"Action,Adventure,Fantasy",Christian Rivers,-84.04896,-30.663623,-14.712583000000002
225,2015-11-06,The Peanuts Movie 2015,99000000,130178411,250091610,119913199,151091610,2015,"Adventure,Animation,Comedy",Steve Martino,31.493344444444443,21.124443434343434,152.61778787878788
226,2018-11-21,Robin Hood 2018,99000000,30824628,84747441,53922813,-14252559,2018,"Action,Adventure,Thriller",Otto Bathurst,-68.86401212121213,-45.53251212121212,-14.396524242424242
227,2017-05-19,Alien: Covenant 2017,97000000,74262031,238521247,164259216,141521247,2017,"Horror,Sci-Fi,Thriller",Ridley Scott,-23.441205154639174,69.33939793814433,145.89819278350515
228,2015-03-13,Cinderella 2015,95000000,201151353,534551353,333400000,439551353,2015,"Drama,Family,Fantasy",Kenneth Branagh,111.73826631578947,250.94736842105263,462.68563473684213
230,2012-07-13,Ice Age: Continental Drift 2012,95000000,161321843,879765137,718443294,784765137,2012,"Adventure,Animation,Comedy","Mike Thurmeier, Steve Martino",69.81246631578948,656.2560989473684,826.068565263158
233,2012-08-10,The Campaign 2012,95000000,86907746,104907746,18000000,9907746,2012,Comedy,Jay Roach,-8.518162105263158,-81.05263157894737,10.429206315789475
235,2016-08-19,Ben-Hur 2016,95000000,26410477,91669648,65259171,-3330352,2016,"Action,Adventure,Drama",Timur Bekmambetov,-72.19949789473684,-31.306135789473682,-3.505633684210526
236,2011-08-05,Rise of the Planet of the Apes 2011,93000000,176760185,470986200,294226015,377986200,2011,"Action,Drama,Sci-Fi",Rupert Wyatt,90.06471505376345,216.37205913978494,406.43677419354833
237,2013-02-14,A Good Day to Die Hard 2013,92000000,67349198,304249198,236900000,212249198,2013,"Action,Thriller",John Moore,-26.79435,157.5,230.70565
238,2013-12-25,The Secret Life of Walter Mitty 2013,91000000,58236838,187861183,129624345,96861183,2013,"Adventure,Comedy,Drama",Ben Stiller,-36.00347472527473,42.44433516483517,106.44086043956045
239,2017-12-20,Jumanji: Welcome to the Jungle 2017,90000000,404508916,964496193,559987277,874496193,2017,"Action,Adventure,Comedy",Jake Kasdan,349.4543511111111,522.2080855555555,971.6624366666666
240,2011-04-15,Rio 2011,90000000,143619809,487519809,343900000,397519809,2011,"Adventure,Animation,Comedy",Carlos Saldanha,59.57756555555556,282.1111111111111,441.6886766666667
241,2011-12-20,The Girl with the Dragon Tattoo 2011,90000000,102515793,239373970,136858177,149373970,2011,"Crime,Drama,Mystery",David Fincher,13.906436666666666,52.06464111111111,165.97107777777777
242,2016-09-23,The Magnificent Seven 2016,90000000,93432655,162525156,69092501,72525156,2016,"Action,Adventure,Western",Antoine Fuqua,3.814061111111111,-23.230554444444447,80.58350666666666
243,2015-12-18,Alvin and the Chipmunks: The Road Chip 2015,90000000,85886987,249517956,163630969,159517956,2015,"Adventure,Animation,Comedy",Walt Becker,-4.570014444444444,81.81218777777778,177.24217333333334
244,2015-07-24,Pixels 2015,90000000,78765986,244041804,165275818,154041804,2015,"Action,Comedy,Sci-Fi",Chris Columbus,-12.482237777777778,83.63979777777779,171.15756
245,2013-08-07,Percy Jackson: Sea of Monsters 2013,90000000,68559554,200859554,132300000,110859554,2013,"Adventure,Family,Fantasy",Thor Freudenthal,-23.822717777777775,47.0,123.17728222222222
246,2016-06-10,Now You See Me 2 2016,90000000,65075540,328325007,263249467,238325007,2016,"Action,Adventure,Comedy",Jon M. Chu,-27.693844444444444,192.49940777777778,264.80556333333334
247,2018-03-16,Tomb Raider 2018,90000000,58250803,273477501,215226698,183477501,2018,"Action,Adventure,Fantasy",Roar Uthaug,-35.27688555555555,139.14077555555556,203.86389
248,2011-08-19,Conan the Barbarian 2011,90000000,21295021,63356133,42061112,-26643867,2011,"Action,Adventure,Fantasy",Marcus Nispel,-76.33886555555556,-53.265431111111106,-29.60429666666667
249,2011-10-21,The Three Musketeers 2011,90000000,20377913,139877913,119500000,49877913,2011,"Action,Adventure,Romance",Paul W.S. Anderson,-77.35787444444443,32.77777777777778,55.41990333333333
250,2017-04-21,The Promise 2017,90000000,8224288,10551417,2327129,-79448583,2017,Drama,Edwine Dorival,-90.86190222222223,-97.41430111111112,-88.27620333333334
255,2017-12-13,Bright 2017,90000000,0,0,0,-90000000,2017,"Action,Crime,Fantasy",David Ayer,-100.0,-100.0,-100.0
256,2018-09-14,The Predator 2018,88000000,51024708,159487563,108462855,71487563,2018,"Action,Adventure,Sci-Fi",Shane Black,-42.01737727272727,23.253244318181817,81.23586704545454
257,2014-03-21,Divergent 2014,85000000,150947895,276014965,125067070,191014965,2014,"Action,Adventure,Mystery",Neil Burger,77.58575882352942,47.13772941176471,224.7234882352941
258,2012-09-28,Hotel Transylvania 2012,85000000,148313048,378505812,230192764,293505812,2012,"Animation,Comedy,Family",Genndy Tartakovsky,74.48593882352941,170.81501647058823,345.30095529411767
259,2019-04-05,Shazam! 2019,85000000,139606856,362899733,223292877,277899733,2019,"Action,Adventure,Comedy",David F. Sandberg,64.24336000000001,162.69750235294117,326.9408623529412
260,2012-02-10,Safe House 2012,85000000,126181630,208542162,82360532,123542162,2012,"Action,Adventure,Crime",Daniel Espinosa,48.448976470588235,-3.1052564705882353,145.34372
261,2011-11-04,Tower Heist 2011,85000000,78046570,150422946,72376376,65422946,2011,"Action,Comedy,Crime",Brett Ratner,-8.180505882352941,-14.851322352941176,76.96817176470589
262,2012-03-30,Mirror Mirror 2012,85000000,64935167,173613482,108678315,88613482,2012,"Adventure,Comedy,Drama",Tarsem Singh,-23.60568588235294,27.85684117647059,104.25115529411764
263,2011-11-23,Arthur Christmas 2011,85000000,46462469,149717124,103254655,64717124,2011,"Adventure,Animation,Comedy","Sarah Smith, Barry Cook",-45.33827176470589,21.476064705882354,76.13779294117647
264,2017-01-20,xXx: Return of Xander Cage 2017,85000000,44898413,345033359,300134946,260033359,2017,"Action,Adventure,Thriller",D.J. Caruso,-47.17833764705882,253.09993647058823,305.9215988235294
266,2017-12-20,The Greatest Showman 2017,84000000,174340174,386665550,212325376,302665550,2017,"Biography,Drama,Musical",Michael Gracey,107.54782619047619,152.76830476190477,360.31613095238095
267,2013-07-19,RED 2 2013,84000000,53262560,141507355,88244795,57507355,2013,"Action,Comedy,Crime",Dean Parisot,-36.59219047619048,5.053327380952381,68.46113690476191
269,2020-02-21,Call of the Wild 2020,82000000,0,0,0,-82000000,2020,"Adventure,Animation,Family",Chris Sanders,-100.0,-100.0,-100.0
270,2012-03-23,The Hunger Games 2012,80000000,408010692,677923379,269912687,597923379,2012,"Action,Adventure,Sci-Fi",Gary Ross,410.013365,237.39085874999998,747.40422375
271,2011-05-26,The Hangover Part II 2011,80000000,254464305,586464305,332000000,506464305,2011,"Comedy,Mystery",Todd Phillips,218.08038125000002,315.0,633.08038125
272,2017-02-10,The Lego Batman Movie 2017,80000000,175750384,310660018,134909634,230660018,2017,"Action,Animation,Comedy",Chris McKay,119.68798000000001,68.6370425,288.3250225
273,2015-09-25,Hotel Transylvania 2 2015,80000000,169700110,469500298,299800188,389500298,2015,"Animation,Comedy,Family",Genndy Tartakovsky,112.1251375,274.750235,486.8753725
274,2013-07-12,Grown Ups 2 2013,80000000,133668525,247023808,113355283,167023808,2013,Comedy,Dennis Dugan,67.08565625,41.69410375,208.77976
275,2011-12-16,Alvin and the Chipmunks: Chipwrecked 2011,80000000,133107389,349088523,215981134,269088523,2011,"Adventure,Animation,Comedy",Mike Mitchell,66.38423625,169.9764175,336.36065375
279,2014-10-17,Fury 2014,80000000,85817906,210315681,124497775,130315681,2014,"Action,Drama,War",David Ayer,7.272382500000001,55.622218749999995,162.89460125
280,2018-09-28,Smallfoot 2018,80000000,83240103,213691277,130451174,133691277,2018,"Adventure,Animation,Comedy","Karey Kirkpatrick, Jason Reisig",4.05012875,63.0639675,167.11409625
281,2011-07-08,Zookeeper 2011,80000000,80360866,170805525,90444659,90805525,2011,"Comedy,Family,Romance",Frank Coraci,0.45108250000000005,13.05582375,113.50690625
282,2019-06-07,The Secret Life of Pets 2 2019,80000000,63795655,113351496,49555841,33351496,2019,"Adventure,Animation,Comedy","Jonathan del Val, Chris Renaud",-20.25543125,-38.05519875,41.68937
283,2015-10-23,The Last Witch Hunter 2015,80000000,27367660,130818912,103451252,50818912,2015,"Action,Adventure,Fantasy",Breck Eisner,-65.790425,29.314065,63.52364
284,2014-02-21,Pompeii 2014,80000000,23169033,108469033,85300000,28469033,2014,"Action,Adventure,Drama",Paul W.S. Anderson,-71.03870875,6.625,35.58629125
285,2012-02-10,Journey 2: The Mysterious Island 2012,79000000,103860290,318146162,214285872,239146162,2012,"Action,Adventure,Comedy",Brad Peyton,31.46872151898734,171.24793924050633,302.71666075949366
286,2011-11-11,Jack and Jill 2011,79000000,74158157,150519217,76361060,71519217,2011,Comedy,Dennis Dugan,-6.1289151898734175,-3.3404303797468353,90.53065443037974
287,2013-09-27,Cloudy with a Chance of Meatballs 2 2013,78000000,119793567,274392649,154599082,196392649,2013,"Adventure,Animation,Comedy","Cody Cameron, Kris Pearn",53.58149615384615,98.20395128205128,251.78544743589742
288,2018-07-20,The Equalizer 2 2018,77000000,102084362,190453132,88368770,113453132,2018,"Action,Crime,Thriller",Antoine Fuqua,32.577093506493505,14.764636363636363,147.34172987012988
289,2013-07-03,Despicable Me 2 2013,76000000,368065385,975216835,607151450,899216835,2013,"Adventure,Animation,Comedy","Chris Renaud, Pierre Coffin",384.2965592105263,698.8834868421053,1183.1800460526315
290,2016-07-08,The Secret Life of Pets 2016,75000000,368384330,886750534,518366204,811750534,2016,"Adventure,Animation,Comedy","Chris Renaud, Yarrow Cheney",391.1791066666667,591.1549386666667,1082.3340453333333
291,2016-12-21,Sing 2016,75000000,270329045,634454789,364125744,559454789,2016,"Animation,Comedy,Family","Christophe Lourdelet, Garth Jennings",260.43872666666664,385.500992,745.9397186666667
292,2017-06-30,Despicable Me 3 2017,75000000,264624300,1034727750,770103450,959727750,2017,"Adventure,Animation,Comedy","Pierre Coffin, Kyle Balda, Eric Guillon",252.8324,926.8046,1279.637
294,2013-05-31,Now You See Me 2013,75000000,117723989,342769200,225045211,267769200,2013,"Crime,Mystery,Thriller",Louis Leterrier,56.96531866666666,200.06028133333334,357.0256
295,2018-08-03,Christopher Robin 2018,75000000,99215042,197504758,98289716,122504758,2018,"Adventure,Animation,Comedy",Marc Forster,32.28672266666667,31.052954666666665,163.33967733333336
296,2011-11-11,Immortals 2011,75000000,83504017,211562435,128058418,136562435,2011,"Action,Drama,Fantasy",Tarsem Singh,11.338689333333333,70.74455733333333,182.08324666666667
298,2011-03-25,Sucker Punch 2011,75000000,36392502,89758389,53365887,14758389,2011,"Action,Adventure,Fantasy",Zack Snyder,-51.47666400000001,-28.845484,19.677852
299,2016-10-28,Inferno 2016,75000000,34343574,219519367,185175793,144519367,2016,"Action,Adventure,Crime",Ron Howard,-54.208568,146.90105733333334,192.69248933333333
300,2015-07-10,Minions 2015,74000000,336045770,1160336173,824290403,1086336173,2015,"Adventure,Animation,Comedy","Pierre Coffin, Kyle Balda",354.1159054054054,1013.90595,1468.0218554054054
301,2015-02-06,The SpongeBob Movie: Sponge Out of Water 2015,74000000,162994032,311013181,148019149,237013181,2015,"Adventure,Animation,Comedy","Mike Mitchell, Paul Tibbitt",120.2622054054054,100.02587702702704,320.2880824324324
302,2016-05-20,The Angry Birds Movie 2016,73000000,107509366,352327887,244818521,279327887,2016,"Action,Animation,Comedy","Clay Kaytis, Fergal Reilly",47.27310410958904,235.36783698630134,382.6409410958904
303,2013-03-22,Olympus Has Fallen 2013,70000000,98927592,172878928,73951336,102878928,2013,"Action,Thriller",Antoine Fuqua,41.325131428571424,5.644765714285714,146.96989714285715
304,2011-12-25,War Horse 2011,70000000,79883359,156815529,76932170,86815529,2011,"Drama,History,War",Steven Spielberg,14.119084285714287,9.9031,124.02218428571427
305,2014-02-07,The Monuments Men 2014,70000000,78031620,158702748,80671128,88702748,2014,"Comedy,Drama,History",George Clooney,11.473742857142858,15.244468571428571,126.71821142857142
306,2016-09-23,Storks 2016,70000000,72679278,183353431,110674153,113353431,2016,"Adventure,Animation,Comedy","Doug Sweetland, Nicholas Stoller",3.82754,58.10593285714286,161.93347285714285
307,2017-09-22,The Lego Ninjago Movie 2017,70000000,59281555,122737201,63455646,52737201,2017,"Action,Adventure,Animation","Charlie Bean, Paul Fisher, Bob Logan",-15.312064285714285,-9.349077142857142,75.33885857142857
308,2014-10-10,Dracula Untold 2014,70000000,55991880,220241723,164249843,150241723,2014,"Action,Drama,Fantasy",Gary Shore,-20.011599999999998,134.64263285714287,214.63103285714286
309,2011-01-14,The Dilemma 2011,70000000,48475290,70546865,22071575,546865,2011,"Comedy,Drama",Ron Howard,-30.749585714285715,-68.46917857142857,0.7812357142857143
310,2012-06-15,Rock of Ages 2012,70000000,38518613,61031932,22513319,-8968068,2012,"Comedy,Drama,Musical",Adam Shankman,-44.97341,-67.83811571428572,-12.811525714285715
311,2016-01-29,The Finest Hours 2016,70000000,27569558,49252761,21683203,-20747239,2016,"Action,Drama,History",Craig Gillespie,-60.61491714285714,-69.02399571428572,-29.638912857142856
312,2013-10-18,Escape Plan 2013,70000000,25135965,103735965,78600000,33735965,2013,"Action,Crime,Mystery",Mikael HÃ¥fstrÃ¶m,-64.09147857142857,12.285714285714286,48.19423571428572
313,2011-09-23,Killer Elite 2011,70000000,25124986,65409046,40284060,-4590954,2011,"Action,Crime,Thriller",Gary McKendry,-64.10716285714285,-42.45134285714286,-6.558505714285714
314,2014-01-10,The Legend of Hercules 2014,70000000,18848538,58953319,40104781,-11046681,2014,"Action,Adventure,Fantasy",Renny Harlin,-73.07351714285714,-42.707455714285715,-15.780972857142858
315,2015-01-16,Blackhat 2015,70000000,8005980,19665004,11659024,-50334996,2015,"Action,Crime,Thriller",Michael Mann,-88.56288571428571,-83.34425142857143,-71.90713714285715
318,2018-03-02,Red Sparrow 2018,69000000,46874505,145951861,99077356,76951861,2018,"Action,Drama,Thriller",Francis Lawrence,-32.06593478260869,43.59037101449275,111.52443623188407
320,2015-06-26,Ted 2 2015,68000000,81476385,217214143,135737758,149214143,2015,Comedy,Seth MacFarlane,19.81821323529412,99.61435,219.4325632352941
321,2011-02-25,Hall Pass 2011,68000000,45060734,87173475,42112741,19173475,2011,"Comedy,Romance","Bobby Farrelly, Peter Farrelly",-33.73421470588235,-38.06949852941177,28.19628676470588
322,2017-12-22,Downsizing 2017,68000000,24449754,54462971,30013217,-13537029,2017,"Drama,Sci-Fi",Alexander Payne,-64.04447941176471,-55.86291617647059,-19.907395588235293
323,2012-06-22,Abraham Lincoln: Vampire Hunter 2012,67500000,37519139,137489730,99970591,69989730,2012,"Action,Fantasy,Horror",Timur Bekmambetov,-44.41609037037037,48.10457925925926,103.68848888888888
324,2014-03-14,Need for Speed 2014,66000000,43568507,194169619,150601112,128169619,2014,"Action,Crime,Thriller",Scott Waugh,-33.987110606060604,128.18350303030303,194.19639242424242
325,2012-11-09,Lincoln 2012,65000000,182207973,273346281,91138308,208346281,2012,"Biography,Drama,History",Steven Spielberg,180.31995846153845,40.21278153846154,320.53274
326,2018-07-13,Hotel Transylvania 3: Summer Vacation 2018,65000000,167500092,527079962,359579870,462079962,2018,"Adventure,Animation,Comedy",Genndy Tartakovsky,157.69244923076923,453.1998,710.8922492307693
327,2014-12-25,Unbroken 2014,65000000,115637895,163527824,47889929,98527824,2014,"Biography,Drama,Sport",Angelina Jolie,77.90445384615384,-26.323186153846155,151.58126769230768
329,2014-12-19,Annie 2014,65000000,85911262,139829625,53918363,74829625,2014,"Comedy,Drama,Family",Will Gluck,32.17117230769231,-17.048672307692307,115.12249999999999
330,2012-05-16,The Dictator 2012,65000000,59650222,180148897,120498675,115148897,2012,Comedy,Larry Charles,-8.230427692307693,85.38257692307693,177.15214923076923
331,2012-02-17,This Means War 2012,65000000,54760791,156974557,102213766,91974557,2012,"Action,Comedy,Romance",McG,-15.75262923076923,57.251947692307695,141.49931846153848
332,2015-02-27,Focus 2015,65000000,53862963,168065700,114202737,103065700,2015,"Comedy,Crime,Drama","John Requa, Glenn Ficarra",-17.133903076923076,75.69651846153846,158.56261538461538
333,2012-11-21,Red Dawn 2012,65000000,44806783,48164150,3357367,-16835850,2012,"Action,Sci-Fi,Thriller",Dan Bradley,-31.066487692307692,-94.83482,-25.90130769230769
334,2015-09-18,Everest 2015,65000000,43482270,221297061,177814791,156297061,2015,"Action,Adventure,Biography",Baltasar KormÃ¡kur,-33.1042,173.56121692307693,240.4570169230769
335,2012-09-14,Resident Evil: Retribution 2012,65000000,42345531,240647629,198302098,175647629,2012,"Action,Horror,Sci-Fi",Paul W.S. Anderson,-34.85302923076923,205.08015076923076,270.2271215384616
336,2014-01-24,"I, Frankenstein 2014",65000000,19075290,74575290,55500000,9575290,2014,"Action,Fantasy,Horror",Stuart Beattie,-70.6534,-14.615384615384617,14.731215384615384
337,2014-08-22,Sin City: A Dame to Kill For 2014,65000000,13757804,40650842,26893038,-24349158,2014,"Crime,Thriller","Robert Rodriguez, Frank Miller",-78.83414769230768,-58.62609538461538,-37.46024307692308
338,2016-12-25,Live by Night 2016,65000000,10378555,21774432,11395877,-43225568,2016,"Action,Crime,Drama",Ben Affleck,-84.03299230769231,-82.46788153846154,-66.50087384615384
339,2018-10-26,Air Strike 2018,65000000,0,516279,516279,-64483721,2018,"Action,Adventure,Drama",Xiao Feng,-100.0,-99.20572461538461,-99.20572461538461
340,2011-04-01,Hop 2011,63000000,108085305,188657593,80572288,125657593,2011,"Adventure,Animation,Comedy",Tim Hill,71.56397619047618,27.892520634920636,199.45649682539684
341,2017-09-15,American Assassin 2017,63000000,36249674,68310140,32060466,5310140,2017,"Action,Thriller",Michael Cuesta,-42.46083492063492,-49.11037142857143,8.42879365079365
342,2015-12-25,The Hateful Eight 2015,62000000,54117416,147864886,93747470,85864886,2015,"Crime,Drama,Mystery",Quentin Tarantino,-12.71384516129032,51.20559677419355,138.49175161290324
343,2014-10-03,Gone Girl 2014,61000000,167767189,368567189,200800000,307567189,2014,"Drama,Mystery,Thriller",David Fincher,175.02817868852458,229.18032786885246,504.20850655737706
344,2015-09-18,Maze Runner: The Scorch Trials 2015,61000000,81697192,310566162,228868970,249566162,2015,"Action,Sci-Fi,Thriller",Wes Ball,33.92982295081967,275.19503278688524,409.12485573770493
345,2013-08-02,2 Guns 2013,61000000,75612460,132493015,56880555,71493015,2013,"Action,Comedy,Crime",Baltasar KormÃ¡kur,23.954852459016394,-6.753188524590165,117.20166393442624
346,2014-02-07,The Lego Movie 2014,60000000,257784718,457729388,199944670,397729388,2014,"Action,Adventure,Animation","Phil Lord, Christopher Miller",329.64119666666664,233.24111666666667,662.8823133333333
347,2016-09-09,Sully 2016,60000000,125070033,238524556,113454523,178524556,2016,"Biography,Drama",Clint Eastwood,108.450055,89.09087166666667,297.5409266666667
349,2012-12-21,Jack Reacher 2012,60000000,80070736,217370736,137300000,157370736,2012,"Action,Crime,Thriller",Christopher McQuarrie,33.45122666666667,128.83333333333334,262.28456
350,2011-09-09,Contagion 2011,60000000,75658097,137551594,61893497,77551594,2011,"Action,Drama,Thriller",Steven Soderbergh,26.096828333333335,3.1558283333333335,129.25265666666667
351,2016-03-04,London Has Fallen 2016,60000000,62524260,195194085,132669825,135194085,2016,"Action,Thriller",Babak Najafi,4.2071,121.116375,225.32347499999997
352,2016-10-21,Jack Reacher: Never Go Back 2016,60000000,58697076,159946489,101249413,99946489,2016,"Action,Thriller",Edward Zwick,-2.17154,68.74902166666666,166.57748166666667
353,2017-05-25,Baywatch 2017,60000000,58060186,175863783,117803597,115863783,2017,"Action,Comedy,Crime",Seth Gordon,-3.233023333333333,96.33932833333333,193.106305
354,2015-12-25,Joy 2015,60000000,56451232,101134059,44682827,41134059,2015,Drama,David O. Russell,-5.9146133333333335,-25.528621666666666,68.556765
355,2012-08-17,ParaNorman 2012,60000000,56003051,108119662,52116611,48119662,2012,"Adventure,Animation,Comedy","Chris Butler, Sam Fell",-6.661581666666666,-13.138981666666666,80.19943666666667
356,2014-09-26,The Boxtrolls 2014,60000000,50837305,111946251,61108946,51946251,2014,"Adventure,Animation,Comedy","Graham Annable, Anthony Stacchi",-15.271158333333334,1.8482433333333332,86.577085
357,2017-08-04,The Dark Tower 2017,60000000,50701325,113461527,62760202,53461527,2017,"Action,Adventure,Fantasy",Nikolaj Arcel,-15.497791666666666,4.600336666666666,89.102545
358,2014-01-17,Jack Ryan: Shadow Recruit 2014,60000000,50577412,131377412,80800000,71377412,2014,"Action,Drama,Thriller",Kenneth Branagh,-15.704313333333333,34.66666666666667,118.96235333333334
359,2018-12-25,Vice 2018,60000000,47836282,70883171,23046889,10883171,2018,"Biography,Comedy,Drama",Adam McKay,-20.272863333333333,-61.58851833333333,18.138618333333334
360,2013-01-11,Gangster Squad 2013,60000000,46000903,104100903,58100000,44100903,2013,"Action,Crime,Drama",Ruben Fleischer,-23.33182833333333,-3.166666666666667,73.501505
361,2017-04-07,Smurfs: The Lost Village 2017,60000000,45020282,197578586,152558304,137578586,2017,"Adventure,Animation,Comedy",Kelly Asbury,-24.96619666666667,154.26384,229.29764333333333
362,2018-10-12,First Man 2018,60000000,44936545,105203825,60267280,45203825,2018,"Biography,Drama,History",Damien Chazelle,-25.105758333333334,0.4454666666666667,75.33970833333333
364,2012-09-21,Trouble with the Curve 2012,60000000,35763137,47818913,12055776,-12181087,2012,"Drama,Sport",Robert Lorenz,-40.39477166666667,-79.90704,-20.301811666666666
365,2019-02-08,Cold Pursuit 2019,60000000,32138862,62599159,30460297,2599159,2019,"Action,Crime,Drama",Hans Petter Moland,-46.43523,-49.23283833333333,4.331931666666667
366,2013-08-21,The Mortal Instruments: City of Bones 2013,60000000,31165421,75965567,44800146,15965567,2013,"Action,Fantasy,Horror",Harald Zwart,-48.057631666666666,-25.333090000000002,26.609278333333336
367,2011-05-13,Priest 2011,60000000,29136626,84154026,55017400,24154026,2011,"Action,Adventure,Fantasy",Scott Stewart,-51.43895666666667,-8.304333333333332,40.25671
368,2015-01-23,Mortdecai 2015,60000000,7696134,30396134,22700000,-29603866,2015,"Action,Comedy,Crime",David Koepp,-87.17311,-62.16666666666667,-49.339776666666666
369,2015-12-11,The Ridiculous 6 2015,60000000,0,0,0,-60000000,2015,"Comedy,Western",Frank Coraci,-100.0,-100.0,-100.0
370,2019-11-08,Midway 2019,59500000,0,0,0,-59500000,2019,"Action,Drama,History",Roland Emmerich,-100.0,-100.0,-100.0
371,2018-03-23,Sherlock Gnomes 2018,59000000,43242871,87527651,44284780,28527651,2018,"Adventure,Animation,Comedy",John Stevenson,-26.706998305084745,-24.94105084745763,48.35195084745762
372,2019-01-25,The Kid Who Would Be King 2019,59000000,16790790,28348446,11557656,-30651554,2019,"Action,Adventure,Family",Joe Cornish,-71.54103389830509,-80.41075254237288,-51.951786440677964
373,2016-02-12,Deadpool 2016,58000000,363070709,801025593,437954884,743025593,2016,"Action,Adventure,Comedy",Tim Miller,525.9839810344827,655.0946275862069,1281.0786086206897
374,2014-12-25,American Sniper 2014,58000000,350126372,547326372,197200000,489326372,2014,"Action,Biography,Drama",Clint Eastwood,503.66615862068966,240.0,843.6661586206898
375,2015-10-16,Goosebumps 2015,58000000,80069458,158905324,78835866,100905324,2015,"Adventure,Comedy,Family",Rob Letterman,38.05078965517241,35.92390689655172,173.97469655172412
376,2012-01-20,Red Tails 2012,58000000,49876377,50365498,489121,-7634502,2012,"Action,Adventure,Drama",Anthony Hemingway,-14.00624655172414,-99.15668793103448,-13.16293448275862
377,2013-06-07,The Internship 2013,58000000,44672764,93672764,49000000,35672764,2013,Comedy,Shawn Levy,-22.977993103448277,-15.517241379310345,61.50476551724138
378,2017-03-24,Life 2017,58000000,30234022,100929666,70695644,42929666,2017,"Horror,Sci-Fi,Thriller",Daniel Espinosa,-47.872375862068964,21.889041379310346,74.01666551724138
380,2012-06-15,That's My Boy 2012,57500000,36931089,58085235,21154146,585235,2012,Comedy,Sean Anders,-35.772019130434785,-63.210180869565214,1.0178
381,2014-12-25,Into the Woods 2014,56200000,128002372,213116401,85114029,156916401,2014,"Adventure,Comedy,Drama",Rob Marshall,127.76222775800711,51.448450177935946,279.21067793594307
382,2018-11-02,Bohemian Rhapsody 2018,55000000,216303339,894985342,678682003,839985342,2018,"Biography,Drama,Music",Bryan Singer,293.27879818181816,1133.9672781818183,1527.2460763636363
383,2017-02-10,Fifty Shades Darker 2017,55000000,114434010,381398492,266964482,326398492,2017,"Drama,Romance",James Foley,108.06183636363636,385.3899672727273,593.4518036363636
384,2013-10-11,Captain Phillips 2013,55000000,107136417,220648184,113511767,165648184,2013,"Biography,Drama,Thriller",Paul Greengrass,94.79348545454546,106.3850309090909,301.1785163636364
385,2017-11-10,Murder on the Orient Express 2017,55000000,102826543,345922730,243096187,290922730,2017,"Crime,Drama,Mystery",Kenneth Branagh,86.95735090909092,341.9930672727273,528.9504181818182
386,2014-09-26,The Equalizer 2014,55000000,101530738,192903624,91372886,137903624,2014,"Action,Crime,Thriller",Antoine Fuqua,84.60134181818182,66.13252,250.7338618181818
387,2018-02-09,Fifty Shades Freed 2018,55000000,100407760,371350619,270942859,316350619,2018,"Drama,Romance,Thriller",James Foley,82.55956363636363,392.62338,575.1829436363637
389,2013-11-01,Free Birds 2013,55000000,55750480,110387072,54636592,55387072,2013,"Adventure,Animation,Comedy",Jimmy Hayward,1.364509090909091,-0.6607418181818181,100.70376727272728
390,2014-03-21,Muppets Most Wanted 2014,55000000,51178893,79312301,28133408,24312301,2014,"Adventure,Comedy,Crime",James Bobin,-6.947467272727273,-48.848349090909096,44.20418363636364
391,2016-08-19,Kubo and the Two Strings 2016,55000000,48023088,77548122,29525034,22548122,2016,"Action,Adventure,Animation",Travis Knight,-12.685294545454544,-46.31812,40.99658545454545
394,2012-07-27,The Watch 2012,55000000,34353000,67130045,32777045,12130045,2012,"Action,Comedy,Horror",Akiva Schaffer,-37.54,-40.40537272727273,22.054627272727274
395,2018-02-23,Annihilation 2018,55000000,32732301,43070915,10338614,-11929085,2018,"Adventure,Drama,Horror",Alex Garland,-40.48672545454545,-81.20252,-21.689245454545457
396,2015-10-16,Crimson Peak 2015,55000000,31090320,74966854,43876534,19966854,2015,"Drama,Fantasy,Horror",Guillermo del Toro,-43.472145454545455,-20.224483636363637,36.30337090909091
397,2012-04-27,The Pirates! Band of Misfits 2012,55000000,31051126,136143605,105092479,81143605,2012,"Adventure,Animation,Comedy","Jeff Newitt, Peter Lord",-43.54340727272727,91.07723454545454,147.53382727272728
398,2015-09-18,Black Mass 2015,53000000,62575678,98837872,36262194,45837872,2015,"Biography,Crime,Drama",Scott Cooper,18.067316981132077,-31.580766037735845,86.48655094339622
399,2012-12-19,Zero Dark Thirty 2012,52500000,95720716,134612435,38891719,82112435,2012,"Drama,Thriller",Kathryn Bigelow,82.32517333333334,-25.920535238095237,156.4046380952381
401,2011-08-05,The Change-Up 2011,52000000,37243418,75997067,38753649,23997067,2011,"Comedy,Fantasy",David Dobkin,-28.378042307692308,-25.47375192307692,46.14820576923077
402,2018-08-17,Alpha 2018,51000000,35851379,99624873,63773494,48624873,2018,"Adventure,Drama,Family",Albert Hughes,-29.70317843137255,25.04606666666667,95.34288823529413
403,2011-03-04,The Adjustment Bureau 2011,50200000,62495645,126931325,64435680,76731325,2011,"Romance,Sci-Fi,Thriller",George Nolfi,24.49331673306773,28.35792828685259,152.8512450199203
404,2012-06-29,Ted 2012,50000000,218665740,556016627,337350887,506016627,2012,"Comedy,Fantasy",Seth MacFarlane,337.33148,574.701774,1012.0332539999999
405,2014-06-13,22 Jump Street 2014,50000000,191719337,331333876,139614539,281333876,2014,"Action,Comedy,Crime","Phil Lord, Christopher Miller",283.438674,179.22907800000002,562.6677520000001
406,2016-06-17,Central Intelligence 2016,50000000,127440871,217194805,89753934,167194805,2016,"Action,Comedy,Crime",Rawson Marshall Thurber,154.881742,79.507868,334.38961
407,2013-12-18,Anchorman 2: The Legend Continues 2013,50000000,127352707,172185754,44833047,122185754,2013,Comedy,Adam McKay,154.705414,-10.333905999999999,244.371508
408,2011-06-10,Super 8 2011,50000000,127004179,257972745,130968566,207972745,2011,"Mystery,Sci-Fi,Thriller",J.J. Abrams,154.008358,161.937132,415.94549
409,2018-11-21,Creed II 2018,50000000,115715889,213591522,97875633,163591522,2018,"Drama,Sport",Steven Caple Jr.,131.431778,95.751266,327.183044
410,2018-02-09,Peter Rabbit 2018,50000000,115234093,347136477,231902384,297136477,2018,"Adventure,Animation,Comedy",Will Gluck,130.468186,363.804768,594.272954
411,2018-12-14,The Mule 2018,50000000,103804407,170857676,67053269,120857676,2018,"Crime,Drama,Thriller",Clint Eastwood,107.608814,34.106538,241.715352
412,2014-02-28,Non-Stop 2014,50000000,91742160,222383055,130640895,172383055,2014,"Action,Mystery,Thriller",Jaume Collet-Serra,83.48432,161.28179,344.76610999999997
413,2017-07-28,The Emoji Movie 2017,50000000,86089513,216562312,130472799,166562312,2017,"Adventure,Animation,Comedy",Tony Leondis,72.17902600000001,160.945598,333.124624
414,2017-12-22,The Post 2017,50000000,81903458,179748880,97845422,129748880,2017,"Biography,Drama,History",Steven Spielberg,63.806916,95.690844,259.49775999999997
415,2011-12-23,We Bought a Zoo 2011,50000000,75624550,118729073,43104523,68729073,2011,"Comedy,Drama,Family",Cameron Crowe,51.249100000000006,-13.790954,137.458146
416,2011-09-23,Moneyball 2011,50000000,75605492,111300835,35695343,61300835,2011,"Biography,Drama,Sport",Bennett Miller,51.210984,-28.609314,122.60167
417,2012-04-06,American Reunion 2012,50000000,56758835,236799211,180040376,186799211,2012,Comedy,"Jon Hurwitz, Hayden Schlossberg",13.51767,260.080752,373.598422
418,2013-01-25,Hansel & Gretel: Witch Hunters 2013,50000000,55703475,214949716,159246241,164949716,2013,"Action,Fantasy,Horror",Tommy Wirkola,11.40695,218.492482,329.899432
419,2017-09-29,American Made 2017,50000000,51342000,135569212,84227212,85569212,2017,"Action,Biography,Comedy",Doug Liman,2.6839999999999997,68.454424,171.138424
420,2014-10-17,The Book of Life 2014,50000000,50151543,97651543,47500000,47651543,2014,"Adventure,Animation,Comedy",Jorge R. GutiÃ©rrez,0.30308599999999997,-5.0,95.30308600000001
421,2014-08-08,Into the Storm 2014,50000000,47602194,150429371,102827177,100429371,2014,"Action,Adventure,Drama",Steven Quale,-4.795612,105.65435400000001,200.858742
422,2014-10-10,The Judge 2014,50000000,47119388,76119388,29000000,26119388,2014,"Crime,Drama",David Dobkin,-5.761224,-42.0,52.238776
423,2016-08-19,War Dogs 2016,50000000,43034523,86234503,43199980,36234503,2016,"Comedy,Crime,Drama",Todd Phillips,-13.930954000000002,-13.60004,72.46900600000001
424,2016-05-20,The Nice Guys 2016,50000000,36261763,59596747,23334984,9596747,2016,"Action,Comedy,Crime",Shane Black,-27.476474,-53.330032,19.193494
427,2016-02-12,Zoolander 2 2016,50000000,28848693,55348693,26500000,5348693,2016,Comedy,Ben Stiller,-42.302614,-47.0,10.697386
428,2013-03-29,The Host 2013,50000000,26623701,64477051,37853350,14477051,2013,"Action,Adventure,Drama",Andrew Niccol,-46.752598,-24.293300000000002,28.954102
429,2015-03-13,Run All Night 2015,50000000,26461644,66961644,40500000,16961644,2015,"Action,Drama,Thriller",Jaume Collet-Serra,-47.076712,-19.0,33.923288
430,2019-04-12,Hellboy 2019,50000000,21903748,40725492,18821744,-9274508,2019,"Action,Adventure,Fantasy",Neil Marshall,-56.192504,-62.356511999999995,-18.549015999999998
431,2011-04-08,Your Highness 2011,50000000,21596445,26121638,4525193,-23878362,2011,"Adventure,Comedy,Fantasy",David Gordon Green,-56.80711000000001,-90.949614,-47.756724
432,2016-09-16,Snowden 2016,50000000,21587519,35380918,13793399,-14619082,2016,"Biography,Drama,Thriller",Oliver Stone,-56.824962,-72.413202,-29.238164
433,2011-09-30,Dream House 2011,50000000,21302340,41642166,20339826,-8357834,2011,"Drama,Mystery,Thriller",Jim Sheridan,-57.395320000000005,-59.320348,-16.715668
434,2016-06-24,Free State of Jones 2016,50000000,20810036,23237252,2427216,-26762748,2016,"Action,Biography,Drama",Gary Ross,-58.37992800000001,-95.145568,-53.525496
435,2013-02-14,Beautiful Creatures 2013,50000000,19452138,60282876,40830738,10282876,2013,"Drama,Fantasy,Romance",Richard LaGravenese,-61.095724,-18.338524,20.565752
436,2011-02-25,Drive Angry 2011,50000000,10721033,41042583,30321550,-8957417,2011,"Action,Fantasy,Thriller",Patrick Lussier,-78.55793399999999,-39.3569,-17.914834
437,2018-02-16,Early Man 2018,50000000,8267544,45285890,37018346,-4714110,2018,"Adventure,Animation,Comedy",Nick Park,-83.464912,-25.963308,-9.42822
438,2015-04-17,Child 44 2015,50000000,1224330,8004221,6779891,-41995779,2015,"Crime,Drama,History",Daniel Espinosa,-97.55134,-86.440218,-83.991558
439,2013-03-15,Upside Down 2013,50000000,102118,26387039,26284921,-23612961,2013,Documentary,Lisa Tahon,-99.79576399999999,-47.430158,-47.225922
440,2019-11-22,The Rhythm Section 2019,50000000,0,0,0,-50000000,2019,"Action,Mystery,Thriller",Reed Morano,-100.0,-100.0,-100.0
441,2019-09-20,Ad Astra 2019,49800000,0,0,0,-49800000,2019,"Adventure,Drama,Mystery",James Gray,-100.0,-100.0,-100.0
442,2015-03-06,Chappie 2015,49000000,31569268,105002056,73432788,56002056,2015,"Action,Crime,Drama",Neill Blomkamp,-35.5729224489796,49.862832653061226,114.28991020408164
443,2012-11-16,Anna Karenina 2012,49000000,12816367,71004627,58188260,22004627,2012,"Drama,Romance",Joe Wright,-73.84414897959184,18.751551020408165,44.90740204081632
444,2018-11-16,Instant Family 2018,48000000,67363237,119736188,52372951,71736188,2018,"Comedy,Drama",Sean Anders,40.340077083333334,9.110314583333333,149.45039166666666
446,2016-07-13,The Infiltrator 2016,47500000,15436808,20718104,5281296,-26781896,2016,"Biography,Crime,Drama",Brad Furman,-67.50145684210527,-88.88148210526316,-56.38293894736842
447,2016-11-11,Arrival 2016,47000000,100546139,203127894,102581755,156127894,2016,"Drama,Mystery,Sci-Fi",Denis Villeneuve,113.92795531914895,118.25905319148937,332.1870085106383
449,2016-12-23,Silence 2016,46500000,7100177,23726626,16626449,-22773374,2016,"Adventure,Drama,History",Martin Scorsese,-84.73080215053763,-64.24419569892473,-48.97499784946236
450,2013-09-20,Prisoners 2013,46000000,61002302,113402302,52400000,67402302,2013,"Crime,Drama,Mystery",Denis Villeneuve,32.6137,13.91304347826087,146.52674347826087
451,2012-10-05,Taken 2 2012,45000000,139854287,377807404,237953117,332807404,2012,"Action,Thriller",Olivier Megaton,210.78730444444443,428.78470444444446,739.572008888889
452,2017-12-22,Pitch Perfect 3 2017,45000000,104897530,185736412,80838882,140736412,2017,"Comedy,Music",Trish Sie,133.10562222222222,79.64196,312.7475822222222
453,2011-11-23,The Muppets 2011,45000000,88625922,160971922,72346000,115971922,2011,"Adventure,Comedy,Family",James Bobin,96.94649333333332,60.76888888888888,257.7153822222222
454,2016-10-07,The Girl on the Train 2016,45000000,75395035,174278214,98883179,129278214,2016,"Crime,Drama,Mystery",Tate Taylor,67.54452222222223,119.74039777777779,287.28492
456,2016-12-09,Office Christmas Party 2016,45000000,54767494,91323299,36555805,46323299,2016,Comedy,"Josh Gordon, Will Speck",21.70554222222222,-18.764877777777777,102.94066444444445
457,2012-07-06,Savages 2012,45000000,47323100,82513490,35190390,37513490,2012,"Crime,Drama,Thriller",Oliver Stone,5.162444444444445,-21.799133333333334,83.36331111111112
458,2014-05-23,Blended 2014,45000000,46290741,127990741,81700000,82990741,2014,"Comedy,Romance",Frank Coraci,2.868313333333333,81.55555555555556,184.42386888888888
459,2017-06-16,All Eyez on Me 2017,45000000,44922302,54876855,9954553,9876855,2017,"Biography,Drama,Music",Benny Boom,-0.17266222222222224,-77.8787711111111,21.948566666666665
460,2019-05-03,UglyDolls 2019,45000000,19894664,24644664,4750000,-20355336,2019,"Adventure,Animation,Comedy",Kelly Asbury,-55.78963555555555,-89.44444444444444,-45.23408
462,2012-09-21,Dredd 2012,45000000,13414714,41467606,28052892,-3532394,2012,"Action,Crime,Sci-Fi",Pete Travis,-70.18952444444444,-37.66024,-7.849764444444444
463,2011-10-28,The Rum Diary 2011,45000000,13109815,21544732,8434917,-23455268,2011,"Comedy,Drama",Bruce Robinson,-70.86707777777778,-81.25574,-52.122817777777776
464,2018-12-21,Welcome to Marwen 2018,45000000,10763520,12874922,2111402,-32125078,2018,"Biography,Comedy,Drama",Robert Zemeckis,-76.08106666666666,-95.30799555555556,-71.38906222222222
465,2011-10-21,Johnny English Reborn 2011,45000000,8406711,164640401,156233690,119640401,2011,"Action,Adventure,Comedy",Oliver Parker,-81.31842,247.1859777777778,265.8675577777778
466,2012-12-31,Foodfight! 2012,45000000,0,73706,73706,-44926294,2012,"Action,Animation,Comedy",Lawrence Kasanoff,-100.0,-99.83620888888889,-99.83620888888889
467,2012-10-12,Argo 2012,44500000,136025503,227140757,91115254,182640757,2012,"Biography,Drama,Thriller",Ben Affleck,205.67528764044943,104.75337977528089,410.42866741573033
469,2014-02-06,The Interview 2014,44000000,6105175,12342632,6237457,-31657368,2014,Comedy,"Evan Goldberg, Seth Rogen",-86.12460227272727,-85.82396136363636,-71.94856363636364
470,2013-06-28,The Heat 2013,43000000,159581587,229727774,70146187,186727774,2013,"Action,Comedy,Crime",Paul Feig,271.1199697674419,63.13066744186047,434.25063720930234
471,2011-01-28,The Mechanic 2011,42500000,29121498,76347393,47225895,33847393,2011,"Action,Crime,Thriller",Simon West,-31.478828235294117,11.11975294117647,79.64092470588236
472,2012-03-16,21 Jump Street 2012,42000000,138447667,202812429,64364762,160812429,2012,"Action,Comedy,Crime","Phil Lord, Christopher Miller",229.63730238095238,53.24943333333333,382.88673571428575
473,2017-05-12,Snatched 2017,42000000,45852178,57852177,11999999,15852177,2017,"Action,Adventure,Comedy",Jonathan Levine,9.17185238095238,-71.42857380952381,37.743278571428576
474,2012-10-12,Here Comes the Boom 2012,42000000,45290318,73239258,27948940,31239258,2012,"Action,Comedy,Sport",Frank Coraci,7.834090476190476,-33.454904761904764,74.37918571428571
475,2011-03-11,Red Riding Hood 2011,42000000,37662162,91678442,54016280,49678442,2011,"Fantasy,Horror,Mystery",Catherine Hardwicke,-10.328185714285715,28.61019047619048,118.28200476190476
476,2018-12-25,Holmes & Watson 2018,42000000,30568743,41926605,11357862,-73395,2018,"Adventure,Comedy,Crime",Etan Cohen,-27.217278571428572,-72.95747142857142,-0.17475
477,2012-01-27,One for the Money 2012,42000000,26414527,36197221,9782694,-5802779,2012,"Action,Comedy,Crime",Julie Anne Robinson,-37.108269047619046,-76.70787142857142,-13.816140476190474
478,2012-01-27,Man on a Ledge 2012,42000000,18620000,49621440,31001440,7621440,2012,"Action,Adventure,Crime",Asger Leth,-55.666666666666664,-26.187047619047622,18.146285714285714
480,2019-05-31,Rocketman 2019,41000000,57342725,108642725,51300000,67642725,2019,"Biography,Drama,Music",Dexter Fletcher,39.86030487804878,25.121951219512194,164.982256097561
481,2011-10-14,The Big Year 2011,41000000,7204138,7684524,480386,-33315476,2011,Comedy,David Frankel,-82.42893170731708,-98.82832682926829,-81.25725853658537
483,2015-02-13,Fifty Shades of Grey 2015,40000000,166167230,570998101,404830871,530998101,2015,"Drama,Romance,Thriller",Sam Taylor-Johnson,315.418075,912.0771775,1327.4952524999999
484,2013-12-13,American Hustle 2013,40000000,150117807,257878294,107760487,217878294,2013,"Crime,Drama",David O. Russell,275.2945175,169.4012175,544.695735
485,2014-07-25,Lucy 2014,40000000,126573960,457507776,330933816,417507776,2014,"Action,Sci-Fi,Thriller",Luc Besson,216.4349,727.3345400000001,1043.76944
486,2013-12-25,Lone Survivor 2013,40000000,125095601,149804632,24709031,109804632,2013,"Action,Biography,Drama",Peter Berg,212.7390025,-38.2274225,274.51158000000004
488,2016-01-15,Ride Along 2 2016,40000000,90862685,124827316,33964631,84827316,2016,"Action,Comedy,Crime",Tim Story,127.1567125,-15.088422500000002,212.06829
489,2015-03-27,Get Hard 2015,40000000,90411453,106511453,16100000,66511453,2015,"Comedy,Crime",Etan Cohen,126.0286325,-59.75,166.2786325
490,2016-10-14,The Accountant 2016,40000000,86260045,152962083,66702038,112962083,2016,"Action,Crime,Drama",Gavin O'Connor,115.65011249999999,66.755095,282.4052075
491,2014-11-14,Dumb and Dumber To 2014,40000000,86208010,156553592,70345582,116553592,2014,"Adventure,Comedy","Bobby Farrelly, Peter Farrelly",115.520025,75.863955,291.38398
492,2014-04-25,The Other Woman 2014,40000000,83911193,195111193,111200000,155111193,2014,"Comedy,Romance",Nick Cassavetes,109.7779825,178.0,387.7779825
493,2015-09-25,The Intern 2015,40000000,75764672,197115710,121351038,157115710,2015,"Comedy,Drama",Nancy Meyers,89.41168,203.37759499999999,392.789275
494,2015-10-16,Bridge of Spies 2015,40000000,72313754,162498338,90184584,122498338,2015,"Drama,History,Thriller",Steven Spielberg,80.784385,125.46146,306.245845
495,2016-11-04,Hacksaw Ridge 2016,40000000,67209615,168904682,101695067,128904682,2016,"Biography,Drama,History",Mel Gibson,68.0240375,154.23766750000001,322.261705
496,2011-02-18,Unknown 2011,40000000,63686397,136123083,72436686,96123083,2011,"Action,Mystery,Thriller",Jaume Collet-Serra,59.215992500000006,81.091715,240.30770750000002
498,2011-03-18,The Lincoln Lawyer 2011,40000000,58009200,87145086,29135886,47145086,2011,"Crime,Drama,Thriller",Brad Furman,45.023,-27.160285000000002,117.86271500000001
499,2014-11-26,Horrible Bosses 2 2014,40000000,54445357,105945357,51500000,65945357,2014,"Comedy,Crime",Sean Anders,36.1133925,28.749999999999996,164.8633925
501,2012-08-15,The Odd Life of Timothy Green 2012,40000000,51853450,55249159,3395709,15249159,2012,"Comedy,Drama,Family",Peter Hedges,29.633625000000002,-91.5107275,38.1228975
502,2014-06-20,Jersey Boys 2014,40000000,47047013,65282732,18235719,25282732,2014,"Biography,Drama,Music",Clint Eastwood,17.6175325,-54.4107025,63.206830000000004
503,2011-08-12,Final Destination 5 2011,40000000,42587643,155011165,112423522,115011165,2011,Horror,Steven Quale,6.4691075,181.058805,287.5279125
504,2018-11-16,Widows 2018,40000000,42402632,73866088,31463456,33866088,2018,"Crime,Drama,Thriller",Steve McQueen,6.0065800000000005,-21.34136,84.66521999999999
505,2014-07-18,Sex Tape 2014,40000000,38543473,126069509,87526036,86069509,2014,"Comedy,Romance",Jake Kasdan,-3.6413175,118.81508999999998,215.17377249999998
506,2011-04-15,Scream 4 2011,40000000,38180928,95989590,57808662,55989590,2011,"Horror,Mystery",Wes Craven,-4.54768,44.521654999999996,139.973975
507,2011-03-18,Paul 2011,40000000,37412945,101162106,63749161,61162106,2011,"Adventure,Comedy,Sci-Fi",Greg Mottola,-6.4676374999999995,59.3729025,152.90526499999999
508,2012-12-19,The Guilt Trip 2012,40000000,37134215,41294674,4160459,1294674,2012,"Comedy,Drama",Anne Fletcher,-7.1644625,-89.5988525,3.2366850000000005
509,2011-08-26,Colombiana 2011,40000000,36665854,72295262,35629408,32295262,2011,"Action,Drama,Thriller",Olivier Megaton,-8.335365,-10.92648,80.738155
510,2018-01-12,The Commuter 2018,40000000,36343858,101985431,65641573,61985431,2018,"Action,Mystery,Thriller",Jaume Collet-Serra,-9.140355,64.1039325,154.9635775
511,2011-04-08,Arthur 2011,40000000,33035397,47787943,14752546,7787943,2011,"Comedy,Romance",Jason Winer,-17.4115075,-63.118635,19.4698575
512,2016-12-21,Patriots Day 2016,40000000,31886361,52837989,20951628,12837989,2016,"Action,Crime,Drama",Peter Berg,-20.2840975,-47.62093,32.094972500000004
514,2019-05-03,Long Shot 2019,40000000,30202860,43711031,13508171,3711031,2019,"Comedy,Romance",Jonathan Levine,-24.49285,-66.2295725,9.2775775
515,2013-12-25,Grudge Match 2013,40000000,29807260,69807260,40000000,29807260,2013,"Comedy,Drama,Sport",Peter Segal,-25.48185,0.0,74.51815
516,2017-08-11,The Nut Job 2: Nutty by Nature 2017,40000000,28370522,57438389,29067867,17438389,2017,"Adventure,Animation,Comedy",Cal Brunker,-29.073695,-27.330332499999997,43.5959725
517,2017-06-30,The House 2017,40000000,25584504,31192425,5607921,-8807575,2017,"Comedy,Crime",Andrew Jay Cohen,-36.038740000000004,-85.9801975,-22.0189375
518,2011-01-07,Season of the Witch 2011,40000000,24827228,91126600,66299372,51126600,2011,"Action,Adventure,Fantasy",Dominic Sena,-37.93193,65.74843,127.8165
519,2016-08-26,Mechanic: Resurrection 2016,40000000,21218403,109738840,88520437,69738840,2016,"Action,Adventure,Thriller",Dennis Gansel,-46.953992500000005,121.30109250000001,174.3471
520,2012-02-03,Big Miracle 2012,40000000,20157300,25268680,5111380,-14731320,2012,"Biography,Drama,Family",Ken Kwapis,-49.60675,-87.22155000000001,-36.828300000000006
521,2012-12-21,The Impossible 2012,40000000,19019882,169590606,150570724,129590606,2012,"Drama,History,Thriller",J.A. Bayona,-52.450295000000004,276.42681,323.976515
522,2012-03-09,A Thousand Words 2012,40000000,18450127,20790486,2340359,-19209514,2012,"Comedy,Drama",Brian Robbins,-53.874682500000006,-94.1491025,-48.023785000000004
523,2015-03-20,The Gunman 2015,40000000,10664749,18594227,7929478,-21405773,2015,"Action,Crime,Drama",Pierre Morel,-73.3381275,-80.176305,-53.5144325
524,2013-08-16,Paranoia 2013,40000000,7388654,16340767,8952113,-23659233,2013,"Drama,Thriller",Robert Luketic,-81.52836500000001,-77.6197175,-59.1480825
525,2015-07-10,Baahubali: The Beginning 2015,40000000,6738000,26736665,19998665,-13263335,2015,"Action,Drama",S.S. Rajamouli,-83.155,-50.0033375,-33.1583375
526,2018-03-09,The Hurricane Heist 2018,40000000,6115824,30963684,24847860,-9036316,2018,"Action,Adventure,Crime",Rob Cohen,-84.71043999999999,-37.88035,-22.59079
527,2015-11-25,Victor Frankenstein 2015,40000000,5775076,31124367,25349291,-8875633,2015,"Drama,Horror,Sci-Fi",Paul McGuigan,-85.56231,-36.6267725,-22.1890825
528,2016-11-11,USS Indianapolis: Men of Courage 2016,40000000,0,1663785,1663785,-38336215,2016,"Action,Drama,History",Mario Van Peebles,-100.0,-95.8405375,-95.8405375
529,2019-09-13,The Goldfinch 2019,40000000,0,0,0,-40000000,2019,Drama,John Crowley,-100.0,-100.0,-100.0
530,2012-10-05,Frankenweenie 2012,39000000,35287788,81150788,45863000,42150788,2012,"Animation,Comedy,Family",Tim Burton,-9.51849230769231,17.597435897435897,108.07894358974359
531,2017-06-02,Captain Underpants: The First Epic Movie 2017,38000000,73921000,126577874,52656874,88577874,2017,"Action,Animation,Comedy",David Soren,94.52894736842106,38.570721052631576,233.09966842105263
532,2015-04-17,Paul Blart: Mall Cop 2 2015,38000000,71091594,107650646,36559052,69650646,2015,"Action,Comedy,Crime",Andy Fickman,87.08314210526315,-3.791968421052631,183.29117368421052
533,2016-12-23,Why Him? 2016,38000000,60323786,117425156,57101370,79425156,2016,Comedy,John Hamburg,58.746805263157896,50.26676315789474,209.01356842105264
534,2011-04-22,Water for Elephants 2011,38000000,58709717,116809717,58100000,78809717,2011,"Drama,Romance",Francis Lawrence,54.4992552631579,52.89473684210526,207.39399210526318
536,2013-09-06,Riddick 2013,38000000,42025135,94763758,52738623,56763758,2013,"Action,Adventure,Sci-Fi",David Twohy,10.592460526315788,38.785849999999996,149.37831052631577
537,2016-01-22,The 5th Wave 2016,38000000,34912982,111336398,76423416,73336398,2016,"Action,Adventure,Drama",J Blakeson,-8.123731578947368,101.11425263157894,192.99052105263158
538,2013-09-20,Rush 2013,38000000,26947624,98230839,71283215,60230839,2013,"Action,Biography,Drama",Ron Howard,-29.0852,87.58740789473684,158.50220789473684
539,2017-10-20,Only the Brave 2017,38000000,18340051,24555177,6215126,-13444823,2017,"Action,Biography,Drama",Joseph Kosinski,-51.736707894736846,-83.64440526315789,-35.38111315789474
540,2011-10-14,The Thing 2011,38000000,16999934,27573078,10573144,-10426922,2011,"Horror,Mystery,Sci-Fi",Matthijs van Heijningen Jr.,-55.26333157894737,-72.17593684210526,-27.43926842105263
541,2018-09-21,The Sisters Brothers 2018,38000000,3143056,13143056,10000000,-24856944,2018,"Adventure,Comedy,Crime",Jacques Audiard,-91.72879999999999,-73.68421052631578,-65.41301052631579
542,2012-05-18,What to Expect When You're Expecting 2012,37500000,41152203,88473016,47320813,50973016,2012,"Comedy,Drama,Romance",Kirk Jones,9.739208000000001,26.188834666666665,135.92804266666667
543,2012-09-14,The Master 2012,37500000,16247159,50647416,34400257,13147416,2012,Drama,Paul Thomas Anderson,-56.674242666666665,-8.265981333333333,35.059776
544,2013-08-07,We're the Millers 2013,37000000,150394119,267816276,117422157,230816276,2013,"Comedy,Crime",Rawson Marshall Thurber,306.4705918918919,217.35718108108108,623.827772972973
545,2015-11-25,Creed 2015,37000000,109767581,173567581,63800000,136567581,2015,"Drama,Sport",Ryan Coogler,196.66913783783784,72.43243243243244,369.10157027027026
547,2011-09-23,Dolphin Tale 2011,37000000,72286779,96068724,23781945,59068724,2011,"Drama,Family",Charles Martin Smith,95.36967297297298,-35.72447297297297,159.6452
548,2018-02-23,Game Night 2018,37000000,69179066,117378084,48199018,80378084,2018,"Action,Comedy,Crime","John Francis Daley, Jonathan Goldstein",86.97044864864864,30.267616216216215,217.23806486486487
550,2011-01-28,The Rite 2011,37000000,33047633,97143987,64096354,60143987,2011,"Drama,Horror,Mystery",Mikael HÃ¥fstrÃ¶m,-10.682072972972973,73.2333891891892,162.5513162162162
551,2015-05-29,Aloha 2015,37000000,21052030,25387091,4335061,-11612909,2015,"Comedy,Drama,Romance",Cameron Crowe,-43.10262162162162,-88.28361891891892,-31.386240540540538
553,2014-09-12,Dolphin Tale 2 2014,36000000,42024533,57824533,15800000,21824533,2014,"Drama,Family",Charles Martin Smith,16.734813888888887,-56.111111111111114,60.62370277777778
554,2016-12-16,Collateral Beauty 2016,36000000,31016021,85309093,54293072,49309093,2016,"Drama,Romance",David Frankel,-13.844386111111112,50.81408888888889,136.96970277777777
555,2011-05-06,There Be Dragons 2011,36000000,1069334,4020990,2951656,-31979010,2011,"Biography,Drama,War",Roland JoffÃ©,-97.02962777777778,-91.80095555555555,-88.83058333333334
556,2017-09-08,It 2017,35000000,327481748,697457969,369976221,662457969,2017,"Horror,Thriller",Andy Muschietti,835.6621371428572,957.0749171428572,1892.7370542857143
558,2013-02-08,Identity Thief 2013,35000000,134506920,175361578,40854658,140361578,2013,"Adventure,Comedy,Crime",Seth Gordon,284.30548571428574,16.727594285714286,401.03308000000004
559,2011-07-08,Horrible Bosses 2011,35000000,117538559,212417601,94879042,177417601,2011,"Comedy,Crime",Seth Gordon,235.82445428571427,171.08297714285715,506.90743142857144
560,2015-07-17,Trainwreck 2015,35000000,110212700,141123897,30911197,106123897,2015,"Comedy,Drama,Romance",Judd Apatow,214.89342857142856,-11.682294285714285,303.21113428571425
561,2013-12-13,Saving Mr. Banks 2013,35000000,83299761,114962525,31662764,79962525,2013,"Biography,Comedy,Drama",John Lee Hancock,137.99931714285714,-9.53496,228.46435714285715
564,2011-07-22,Friends with Benefits 2011,35000000,55802754,146595891,90793137,111595891,2011,"Comedy,Romance",Will Gluck,59.436440000000005,159.40896285714285,318.84540285714286
565,2016-05-20,Neighbors 2: Sorority Rising 2016,35000000,55340730,108757621,53416891,73757621,2016,Comedy,Nicholas Stoller,58.11637142857143,52.61968857142857,210.73605999999998
566,2018-06-29,Sicario: Day of the Soldado 2018,35000000,50065850,75885196,25819346,40885196,2018,"Action,Crime,Drama",Stefano Sollima,43.04528571428571,-26.230439999999998,116.81484571428571
567,2015-05-22,Poltergeist 2015,35000000,47425125,95713069,48287944,60713069,2015,"Horror,Thriller",Gil Kenan,35.50035714285714,37.96555428571429,173.46591142857142
568,2018-10-12,Goosebumps 2: Haunted Halloween 2018,35000000,46697321,93291478,46594157,58291478,2018,"Adventure,Comedy,Family",Ari Sandel,33.42091714285714,33.12616285714285,166.54708
569,2018-01-19,12 Strong 2018,35000000,45819713,71118378,25298665,36118378,2018,"Action,Drama,History",Nicolai Fuglsig,30.913465714285714,-27.7181,103.19536571428571
570,2011-05-06,Something Borrowed 2011,35000000,39046489,65084116,26037627,30084116,2011,"Comedy,Drama,Romance",Luke Greenfield,11.561397142857142,-25.60678,85.95461714285715
571,2011-10-28,In Time 2011,35000000,37553932,165103952,127550020,130103952,2011,"Action,Crime,Drama",Andrew Niccol,7.296948571428572,264.4286285714286,371.72557714285716
573,2011-11-09,J. Edgar 2011,35000000,37306030,84606030,47300000,49606030,2011,"Biography,Crime,Drama",Clint Eastwood,6.588657142857143,35.14285714285714,141.7315142857143
574,2018-08-17,Mile 22 2018,35000000,36108758,66295121,30186363,31295121,2018,"Action,Adventure,Thriller",Peter Berg,3.16788,-13.753248571428573,89.41463142857144
575,2015-05-08,Hot Pursuit 2015,35000000,34580201,45671512,11091311,10671512,2015,"Action,Comedy,Crime",Anne Fletcher,-1.1994257142857143,-68.31054,30.490034285714284
576,2015-12-25,Concussion 2015,35000000,34531832,50363790,15831958,15363790,2015,"Biography,Drama,Sport",Peter Landesman,-1.3376228571428572,-54.76583428571429,43.896542857142855
577,2017-10-13,The Foreigner 2017,35000000,34393507,140783360,106389853,105783360,2017,"Action,Thriller",Martin Campbell,-1.7328371428571427,203.97100857142857,302.23817142857143
578,2018-06-01,Adrift 2018,35000000,31445011,57897191,26452180,22897191,2018,"Action,Adventure,Biography",Baltasar KormÃ¡kur,-10.15711142857143,-24.422342857142855,65.42054571428572
579,2011-09-23,Abduction 2011,35000000,28087155,86648359,58561204,51648359,2011,"Action,Mystery,Thriller",John Singleton,-19.750985714285715,67.31772571428571,147.56674
581,2012-10-19,Alex Cross 2012,35000000,25888412,35426759,9538347,426759,2012,"Action,Crime,Mystery",Rob Cohen,-26.03310857142857,-72.74758,1.2193114285714286
582,2016-03-04,Whiskey Tango Foxtrot 2016,35000000,23083334,25350747,2267413,-9649253,2016,"Biography,Comedy,Drama","John Requa, Glenn Ficarra",-34.04761714285714,-93.52167714285714,-27.569294285714285
583,2015-08-21,Hitman: Agent 47 2015,35000000,22467450,82182803,59715353,47182803,2015,"Action,Adventure,Crime",Aleksander Bach,-35.80728571428571,70.61529428571428,134.80800857142856
584,2012-08-24,Premium Rush 2012,35000000,20275446,31393201,11117755,-3606799,2012,"Action,Crime,Thriller",David Koepp,-42.07015428571428,-68.23498571428571,-10.30514
585,2013-01-18,Broken City 2013,35000000,19701164,34480045,14778881,-519955,2013,"Crime,Drama,Thriller",Allen Hughes,-43.71096,-57.77462571428571,-1.4855857142857143
587,2013-01-25,Parker 2013,35000000,17616641,48543388,30926747,13543388,2013,"Action,Crime,Thriller",Taylor Hackford,-49.66674,-11.637865714285715,38.695394285714286
588,2011-05-27,The Tree of Life 2011,35000000,13305665,61721826,48416161,26721826,2011,"Drama,Fantasy",Terrence Malick,-61.98381428571429,38.33188857142857,76.34807428571429
589,2014-03-28,Sabotage 2014,35000000,10508518,18376443,7867925,-16623557,2014,"Action,Crime,Drama",David Ayer,-69.97566285714286,-77.52021428571429,-47.49587714285714
590,2015-03-06,Unfinished Business 2015,35000000,10219501,13214051,2994550,-21785949,2015,"Comedy,Drama",Ken Scott,-70.80142571428571,-91.44414285714285,-62.245568571428564
591,2015-09-30,The Walk 2015,35000000,10161183,61492104,51330921,26492104,2015,"Crime,Thriller",Timothy Fielding,-70.96804857142858,46.659774285714285,75.69172571428572
593,2013-11-29,Mandela: Long Walk to Freedom 2013,35000000,8323085,29890402,21567317,-5109598,2013,"Biography,Drama,History",Justin Chadwick,-76.21975714285715,-38.37909428571429,-14.59885142857143
594,2016-03-11,The Brothers Grimsby 2016,35000000,6864016,28720470,21856454,-6279530,2016,"Action,Adventure,Comedy",Louis Leterrier,-80.38852571428572,-37.55298857142857,-17.941514285714284
595,2017-10-20,The Snowman 2017,35000000,6670765,43226146,36555381,8226146,2017,"Crime,Drama,Mystery",Tomas Alfredson,-80.94067142857143,4.443945714285714,23.503274285714284
596,2016-04-22,A Hologram for the King 2016,35000000,4212494,11846010,7633516,-23153990,2016,"Comedy,Drama,Romance",Tom Tykwer,-87.96430285714287,-78.18995428571428,-66.15425714285715
597,2012-09-14,Stolen 2012,35000000,289773,17967746,17677973,-17032254,2012,"Action,Crime,Thriller",Simon West,-99.17207714285713,-49.491505714285715,-48.663582857142856
598,2011-10-14,Trespass 2011,35000000,16816,786532,769716,-34213468,2011,"Crime,Drama,Thriller",Joel Schumacher,-99.95195428571428,-97.80081142857144,-97.75276571428572
599,2011-12-25,The Darkest Hour 2011,34800000,21443494,62831715,41388221,28031715,2011,"Action,Adventure,Horror",Chris Gorak,-38.38076436781609,18.931669540229883,80.55090517241379
600,2017-06-28,Baby Driver 2017,34000000,107825862,228104185,120278323,194104185,2017,"Action,Crime,Drama",Edgar Wright,217.1348882352941,253.75977352941175,570.8946617647059
601,2014-09-19,The Maze Runner 2014,34000000,102427862,348319861,245891999,314319861,2014,"Action,Mystery,Sci-Fi",Wes Ball,201.25841764705882,623.2117617647059,924.4701794117648
602,2015-04-10,The Longest Ride 2015,34000000,37446117,63802928,26356811,29802928,2015,"Drama,Romance",George Tillman Jr.,10.135638235294117,-22.479967647058825,87.6556705882353
603,2018-08-03,The Darkest Minds 2018,34000000,12695691,38361428,25665737,4361428,2018,"Action,Adventure,Drama",Jennifer Yuh Nelson,-62.65973235294118,-24.51253823529412,12.827729411764707
604,2016-07-08,Mike and Dave Need Wedding Dates 2016,33000000,46009673,75898100,29888427,42898100,2016,"Adventure,Comedy,Romance",Jake Szymanski,39.42325151515151,-9.42900909090909,129.99424242424243
605,2012-07-27,Step Up Revolution 2012,33000000,35074677,165552290,130477613,132552290,2012,"Drama,Music,Romance",Scott Speer,6.286899999999999,295.38670606060606,401.67360606060606
606,2012-04-27,Safe 2012,33000000,17142080,41495213,24353133,8495213,2012,"Action,Crime,Thriller",Boaz Yakin,-48.05430303030303,-26.202627272727273,25.743069696969695
607,2015-10-30,Freaks of Nature 2015,33000000,70958,70958,0,-32929042,2015,"Comedy,Horror,Sci-Fi",Robbie Pickering,-99.78497575757575,-100.0,-99.78497575757575
608,2011-05-13,Bridesmaids 2011,32500000,169211718,289632023,120420305,257132023,2011,"Comedy,Romance",Paul Feig,420.65144,270.5240153846154,791.1754553846154
609,2013-04-26,The Big Wedding 2013,32500000,21819348,48425971,26606623,15925971,2013,"Comedy,Drama,Romance",Justin Zackham,-32.86354461538462,-18.133467692307693,49.00298769230769
610,2012-02-24,Wanderlust 2012,32500000,17288155,24159934,6871779,-8340066,2012,"Comedy,Romance",David Wain,-46.80567692307692,-78.85606461538461,-25.66174153846154
612,2011-04-01,Source Code 2011,32000000,54712227,140428499,85716272,108428499,2011,"Action,Drama,Sci-Fi",Duncan Jones,70.975709375,167.86335,338.83905937500003
613,2018-04-20,I Feel Pretty 2018,32000000,48795601,91553797,42758196,59553797,2018,"Comedy,Romance","Marc Silverstein, Abby Kohn",52.486253125000005,33.6193625,186.105615625
614,2011-02-18,"Big Mommas: Like Father, Like Son 2011",32000000,37915414,82332450,44417036,50332450,2011,"Action,Comedy,Crime",John Whitesell,18.485668750000002,38.8032375,157.28890625
615,2013-03-15,The Incredible Burt Wonderstone 2013,32000000,22537881,27392609,4854728,-4607391,2013,"Adventure,Comedy,Fantasy",Don Scardino,-29.569121874999997,-84.828975,-14.398096875
616,2018-10-12,Bad Times at the El Royale 2018,32000000,17839115,29204379,11365264,-2795621,2018,"Crime,Drama,Mystery",Drew Goddard,-44.252765625,-64.48355,-8.736315625
619,2016-04-15,Criminal 2016,31500000,14708696,38771262,24062566,7271262,2016,"Action,Crime,Drama",Ariel Vromen,-53.30572698412699,-23.610901587301587,23.08337142857143
620,2013-04-12,42 2013,31000000,95020213,97470701,2450488,66470701,2013,"Biography,Drama,Sport",Brian Helgeland,206.51681612903226,-92.0952,214.42161612903226
621,2012-11-02,Flight 2012,31000000,93772375,160558438,66786063,129558438,2012,"Drama,Thriller",Robert Zemeckis,202.49153225806452,115.43891290322581,417.9304451612904
622,2014-03-07,The Grand Budapest Hotel 2014,31000000,59076019,163981261,104905242,132981261,2014,"Adventure,Comedy,Crime",Wes Anderson,90.56780322580646,238.4040064516129,428.97180967741934
623,2015-07-29,Vacation 2015,31000000,58884188,102306500,43422312,71306500,2015,"Adventure,Comedy","John Francis Daley, Jonathan Goldstein",89.94899354838711,40.071974193548385,230.0209677419355
625,2018-08-15,Crazy Rich Asians 2018,30000000,174532921,238099711,63566790,208099711,2018,"Comedy,Romance",Jon M. Chu,481.7764033333333,111.88929999999999,693.6657033333333
626,2012-02-10,The Vow 2012,30000000,125014030,197618160,72604130,167618160,2012,"Drama,Romance",Michael Sucsy,316.71343333333334,142.01376666666667,558.7271999999999
627,2013-08-16,Lee Daniels' The Butler 2013,30000000,116632095,177025498,60393403,147025498,2013,"Biography,Drama",Lee Daniels,288.77365,101.31134333333334,490.08499333333333
628,2015-12-18,Sisters 2015,30000000,87044645,106030660,18986015,76030660,2015,Comedy,Jason Moore,190.14881666666668,-36.71328333333334,253.43553333333335
630,2012-09-28,Looper 2012,30000000,66486205,170466405,103980200,140466405,2012,"Action,Crime,Drama",Rian Johnson,121.62068333333333,246.60066666666665,468.22135
631,2013-02-01,Warm Bodies 2013,30000000,66380662,115121608,48740946,85121608,2013,"Comedy,Horror,Romance",Jonathan Levine,121.26887333333333,62.46982,283.73869333333334
632,2014-01-17,The Nut Job 2014,30000000,64251538,122529966,58278428,92529966,2014,"Adventure,Animation,Comedy",Peter Lepeniotis,114.17179333333334,94.26142666666667,308.43322
633,2012-08-08,Hope Springs 2012,30000000,63536011,133085295,69549284,103085295,2012,"Comedy,Drama,Romance",David Frankel,111.78670333333334,131.83094666666665,343.61765
634,2011-05-20,Midnight in Paris 2011,30000000,56816662,162502774,105686112,132502774,2011,"Comedy,Fantasy,Romance",Woody Allen,89.38887333333334,252.28704,441.67591333333337
635,2017-11-22,Darkest Hour 2017,30000000,56443120,150807172,94364052,120807172,2017,"Biography,Drama,History",Joe Wright,88.14373333333333,214.54684,402.6905733333333
636,2018-05-11,Life of the Party 2018,30000000,53059911,65759911,12700000,35759911,2018,Comedy,Ben Falcone,76.86636999999999,-57.666666666666664,119.19970333333335
638,2015-07-24,Southpaw 2015,30000000,52421953,94156456,41734503,64156456,2015,"Drama,Sport",Antoine Fuqua,74.73984333333334,39.11501,213.85485333333332
639,2017-07-28,Atomic Blonde 2017,30000000,51573925,98345423,46771498,68345423,2017,"Action,Mystery,Thriller",David Leitch,71.91308333333333,55.90499333333333,227.81807666666666
640,2015-09-18,Sicario 2015,30000000,46889293,84393749,37504456,54393749,2015,"Action,Crime,Drama",Denis Villeneuve,56.29764333333333,25.01485333333333,181.31249666666668
641,2018-01-19,Den of Thieves 2018,30000000,44947622,80131391,35183769,50131391,2018,"Action,Crime,Drama",Christian Gudegast,49.825406666666666,17.279230000000002,167.10463666666666
642,2012-04-13,The Three Stooges 2012,30000000,44338224,54052249,9714025,24052249,2012,"Comedy,Family","Bobby Farrelly, Peter Farrelly",47.79408,-67.61991666666667,80.17416333333334
643,2014-10-24,John Wick 2014,30000000,43037835,76235001,33197166,46235001,2014,"Action,Crime,Thriller","David Leitch, Chad Stahelski",43.45945,10.65722,154.11667
644,2015-04-24,The Age of Adaline 2015,30000000,42629776,68984536,26354760,38984536,2015,"Drama,Fantasy,Romance",Lee Toland Krieger,42.09925333333333,-12.1508,129.94845333333333
646,2011-04-08,Hanna 2011,30000000,40259119,65343694,25084575,35343694,2011,"Action,Drama,Thriller",Joe Wright,34.19706333333333,-16.38475,117.81231333333334
647,2013-09-13,The Family 2013,30000000,36918811,51078541,14159730,21078541,2013,"Comedy,Crime,Thriller",Luc Besson,23.062703333333335,-52.8009,70.26180333333333
649,2018-02-09,The 15:17 to Paris 2018,30000000,36276286,56096200,19819914,26096200,2018,"Biography,Drama,Thriller",Clint Eastwood,20.920953333333333,-33.93362,86.98733333333334
650,2011-07-01,Larry Crowne 2011,30000000,35608245,61449135,25840890,31449135,2011,"Comedy,Drama,Romance",Tom Hanks,18.69415,-13.863700000000001,104.83045
651,2013-10-18,Carrie 2013,30000000,35266619,82409520,47142901,52409520,2013,"Drama,Horror",Kimberly Peirce,17.555396666666667,57.14300333333333,174.69840000000002
652,2018-03-02,Death Wish 2018,30000000,34017028,48575965,14558937,18575965,2018,"Action,Crime,Drama",Eli Roth,13.390093333333333,-51.47021000000001,61.91988333333334
653,2015-06-03,Entourage 2015,30000000,32363404,46438538,14075134,16438538,2015,Comedy,Doug Ellin,7.8780133333333335,-53.08288666666666,54.79512666666667
654,2013-02-08,Side Effects 2013,30000000,32172757,66742138,34569381,36742138,2013,"Crime,Drama,Mystery",Steven Soderbergh,7.242523333333334,15.23127,122.47379333333332
655,2014-07-02,Deliver Us from Evil 2014,30000000,30577122,87956618,57379496,57956618,2014,"Horror,Mystery,Thriller",Scott Derrickson,1.9237400000000002,91.26498666666667,193.18872666666667
656,2014-08-01,Get on Up 2014,30000000,30569935,33339868,2769933,3339868,2014,"Biography,Drama,Music",Tate Taylor,1.8997833333333332,-90.76689,11.132893333333334
657,2012-04-27,The Five-Year Engagement 2012,30000000,28700285,61623819,32923534,31623819,2012,"Comedy,Romance",Nicholas Stoller,-4.3323833333333335,9.745113333333332,105.41273
658,2011-07-15,Winnie the Pooh 2011,30000000,26692846,50145607,23452761,20145607,2011,"Adventure,Animation,Comedy","Don Hall, Stephen J. Anderson",-11.023846666666667,-21.82413,67.15202333333333
659,2018-09-14,White Boy Rick 2018,30000000,24004833,25947983,1943150,-4052017,2018,"Crime,Drama",Yann Demange,-19.983890000000002,-93.52283333333334,-13.506723333333333
660,2011-02-04,Sanctum 2011,30000000,23209310,108957098,85747788,78957098,2011,"Adventure,Drama,Thriller",Alister Grierson,-22.63563333333333,185.82596,263.1903266666667
662,2018-01-12,Proud Mary 2018,30000000,20868638,21709539,840901,-8290461,2018,"Action,Crime,Drama",Babak Najafi,-30.437873333333332,-97.19699666666666,-27.63487
663,2013-10-04,Runner Runner 2013,30000000,19316646,60512680,41196034,30512680,2013,"Crime,Thriller",Brad Furman,-35.61118,37.32011333333333,101.70893333333333
664,2017-04-28,Baahubali 2: The Conclusion 2017,30000000,18985794,263502914,244517120,233502914,2017,"Action,Drama",S.S. Rajamouli,-36.714020000000005,715.0570666666667,778.3430466666666
665,2011-08-19,Fright Night 2011,30000000,18298649,40520649,22222000,10520649,2011,"Comedy,Horror",Craig Gillespie,-39.00450333333333,-25.926666666666666,35.06883
666,2015-10-09,Steve Jobs 2015,30000000,17766658,35579007,17812349,5579007,2015,"Biography,Drama",Danny Boyle,-40.77780666666666,-40.625503333333334,18.59669
667,2013-01-18,The Last Stand 2013,30000000,12050299,48330757,36280458,18330757,2013,"Action,Thriller",Jee-woon Kim,-59.83233666666666,20.93486,61.10252333333334
668,2013-03-08,Dead Man Down 2013,30000000,10895295,19599974,8704679,-10400026,2013,"Action,Crime,Drama",Niels Arden Oplev,-63.68235,-70.98440333333333,-34.66675333333333
669,2017-02-03,The Space Between Us 2017,30000000,7885294,16481405,8596111,-13518595,2017,"Adventure,Drama,Romance",Peter Chelsom,-73.71568666666667,-71.34629666666666,-45.06198333333333
670,2018-08-31,Kin 2018,30000000,5718096,10096821,4378725,-19903179,2018,"Action,Drama,Sci-Fi","Jonathan Baker, Josh Baker",-80.93968000000001,-85.40425,-66.34393
671,2017-09-22,Stronger 2017,30000000,4211129,8786752,4575623,-21213248,2017,"Biography,Drama",David Gordon Green,-85.96290333333333,-84.74792333333333,-70.71082666666668
673,2019-06-14,Shaft 2019,30000000,600000,600000,0,-29400000,2019,"Action,Comedy,Crime",Tim Story,-98.0,-100.0,-98.0
674,2011-09-23,Machine Gun Preacher 2011,30000000,538690,3721988,3183298,-26278012,2011,"Action,Biography,Crime",Marc Forster,-98.20436666666666,-89.38900666666667,-87.59337333333333
675,2015-01-30,Wild Card 2015,30000000,3200,4315789,4312589,-25684211,2015,"Action,Crime,Drama",Simon West,-99.98933333333333,-85.62470333333333,-85.61403666666666
676,2015-05-15,Pitch Perfect 2 2015,29000000,184296230,287625468,103329238,258625468,2015,"Comedy,Music",Elizabeth Banks,535.5042413793104,256.30771724137935,891.8119586206897
677,2018-09-28,Night School 2018,29000000,77339130,103008792,25669662,74008792,2018,Comedy,Malcolm D. Lee,166.6866551724138,-11.483924137931034,255.20273103448275
678,2016-04-08,The Boss 2016,29000000,63077560,78652207,15574647,49652207,2016,Comedy,Ben Falcone,117.50882758620689,-46.29432068965517,171.21450689655174
679,2017-08-18,Logan Lucky 2017,29000000,27778642,44264271,16485629,15264271,2017,"Comedy,Crime,Drama",Steven Soderbergh,-4.211579310344828,-43.15300344827586,52.635417241379315
680,2016-08-12,Florence Foster Jenkins 2016,29000000,27383770,56000339,28616569,27000339,2016,"Biography,Comedy,Drama",Stephen Frears,-5.573206896551723,-1.3221758620689654,93.1046172413793
681,2015-08-14,Straight Outta Compton 2015,28000000,161197785,202182981,40985196,174182981,2015,"Biography,Drama,History",F. Gary Gray,475.70637500000004,46.375699999999995,622.0820749999999
682,2017-07-21,Girls Trip 2017,28000000,115108515,140886353,25777838,112886353,2017,"Comedy,Drama",Malcolm D. Lee,311.1018392857143,-7.936292857142857,403.1655464285715
683,2017-11-01,A Bad Moms Christmas 2017,28000000,72110659,127710550,55599891,99710550,2017,"Adventure,Comedy","Jon Lucas, Scott Moore",157.53806785714286,98.57103928571429,356.1091071428571
684,2013-02-14,Safe Haven 2013,28000000,71399120,94050951,22651831,66050951,2013,"Drama,Romance,Thriller",Lasse HallstrÃ¶m,154.99685714285712,-19.10060357142857,235.8962535714286
685,2015-12-11,The Big Short 2015,28000000,70259870,133162752,62902882,105162752,2015,"Biography,Comedy,Drama",Adam McKay,150.92810714285713,124.65315,375.5812571428571
686,2014-10-10,"Alexander and the Terrible, Horrible, No Good, Very Bad Day 2014",28000000,66954149,101379287,34425138,73379287,2014,"Comedy,Family",Miguel Arteta,139.1219607142857,22.94692142857143,262.06888214285715
687,2013-01-28,Last Vegas 2013,28000000,63914167,112914167,49000000,84914167,2013,"Comedy,Drama",Jon Turteltaub,128.26488214285715,75.0,303.2648821428571
688,2018-06-15,Tag 2018,28000000,54730625,77026186,22295561,49026186,2018,Comedy,Jeff Tomsic,95.46651785714285,-20.37299642857143,175.09352142857142
690,2011-08-12,30 Minutes or Less 2011,28000000,37053924,40966716,3912792,12966716,2011,"Action,Comedy,Crime",Ruben Fleischer,32.33544285714286,-86.02574285714286,46.3097
691,2014-02-21,3 Days to Kill 2014,28000000,30697999,38959900,8261901,10959900,2014,"Action,Drama,Thriller",McG,9.635710714285715,-70.49321071428571,39.142500000000005
692,2013-08-16,Kick-Ass 2 2013,28000000,28795985,63129909,34333924,35129909,2013,"Action,Comedy,Crime",Jeff Wadlow,2.8428035714285715,22.621157142857143,125.46396071428572
693,2014-09-19,A Walk Among the Tombstones 2014,28000000,26017685,62108587,36090902,34108587,2014,"Action,Crime,Drama",Scott Frank,-7.079696428571429,28.896078571428575,121.81638214285715
695,2014-04-25,Brick Mansions 2014,28000000,20396829,73421224,53024395,45421224,2014,"Action,Crime",Camille Delamarre,-27.15418214285714,89.37283928571429,162.21865714285715
696,2015-08-21,American Ultra 2015,28000000,14439985,30295028,15855043,2295028,2015,"Action,Comedy,Sci-Fi",Nima Nourizadeh,-48.428625,-43.37484642857143,8.196528571428571
697,2016-02-05,Pride and Prejudice and Zombies 2016,28000000,10907291,16638300,5731009,-11361700,2016,"Action,Comedy,Horror",Burr Steers,-61.04538928571429,-79.53211071428572,-40.5775
698,2012-01-13,Joyful Noise 2012,27500000,30932113,31157914,225801,3657914,2012,"Comedy,Drama,Music",Todd Graff,12.48041090909091,-99.17890545454546,13.301505454545454
699,2011-10-28,Anonymous 2011,27500000,4463292,15815509,11352217,-11684491,2011,"Drama,Thriller",Roland Emmerich,-83.76984727272728,-58.71921090909091,-42.48905818181819
700,2011-03-18,Limitless 2011,27000000,79249455,155564919,76315464,128564919,2011,"Mystery,Sci-Fi,Thriller",Neil Burger,193.5165,182.64986666666667,476.16636666666665
701,2016-05-13,Money Monster 2016,27000000,41012075,93466095,52454020,66466095,2016,"Crime,Drama,Thriller",Jodie Foster,51.896574074074074,94.27414814814816,246.1707222222222
702,2013-04-26,Pain & Gain 2013,26000000,49875291,81275291,31400000,55275291,2013,"Action,Comedy,Crime",Michael Bay,91.8280423076923,20.76923076923077,212.5972730769231
704,2012-08-29,Lawless 2012,26000000,37397291,54393687,16996396,28393687,2012,"Crime,Drama",John Hillcoat,43.83573461538462,-34.629246153846154,109.20648846153847
705,2014-10-17,The Best of Me 2014,26000000,26766213,41059418,14293205,15059418,2014,"Drama,Romance",Michael Hoffman,2.946973076923077,-45.02613461538461,57.92083846153846
706,2012-04-27,The Raven 2012,26000000,16008272,30601801,14593529,4601801,2012,"Crime,Mystery,Thriller",James McTeigue,-38.429723076923075,-43.871042307692306,17.699234615384615
707,2013-10-18,The Fifth Estate 2013,26000000,3254172,6154172,2900000,-19845828,2013,"Biography,Drama,Thriller",Bill Condon,-87.48395384615385,-88.84615384615384,-76.33010769230769
708,2014-03-21,Blood Ties 2014,26000000,42472,2923959,2881487,-23076041,2014,Documentary,Stefania MÃ¼ller,-99.83664615384615,-88.9173576923077,-88.75400384615385
709,2015-03-17,Accidental Love 2015,26000000,0,135436,135436,-25864564,2015,"Comedy,Romance",David O. Russell,-100.0,-99.47909230769231,-99.47909230769231
710,2011-08-10,The Help 2011,25000000,169705587,213120004,43414417,188120004,2011,Drama,Tate Taylor,578.822348,73.657668,752.480016
711,2016-12-25,Hidden Figures 2016,25000000,169607287,231771716,62164429,206771716,2016,"Biography,Drama,History",Theodore Melfi,578.429148,148.657716,827.086864
712,2014-01-17,Ride Along 2014,25000000,134202565,153733800,19531235,128733800,2014,"Action,Comedy,Crime",Tim Story,436.81026,-21.875059999999998,514.9352
714,2012-12-25,Parental Guidance 2012,25000000,77267296,120832383,43565087,95832383,2012,"Comedy,Family",Andy Fickman,209.06918399999998,74.260348,383.329532
715,2011-01-21,No Strings Attached 2011,25000000,70662220,149228078,78565858,124228078,2011,"Comedy,Romance",Ivan Reitman,182.64888,214.263432,496.912312
716,2012-01-13,Contraband 2012,25000000,66528000,98406855,31878855,73406855,2012,"Action,Crime,Drama",Baltasar KormÃ¡kur,166.112,27.515420000000002,293.62742000000003
717,2012-04-20,The Lucky One 2012,25000000,60457138,96633833,36176695,71633833,2012,"Drama,Romance",Scott Hicks,141.828552,44.70678,286.535332
718,2011-04-22,Madea's Big Happy Family 2011,25000000,53345287,54160818,815531,29160818,2011,"Comedy,Drama",Tyler Perry,113.38114800000001,-96.737876,116.643272
719,2014-08-15,The Giver 2014,25000000,45090374,66540205,21449831,41540205,2014,"Drama,Romance,Sci-Fi",Phillip Noyce,80.361496,-14.200676000000001,166.16082
720,2015-11-20,The Night Before 2015,25000000,43035725,52427346,9391621,27427346,2015,"Adventure,Comedy,Fantasy",Jonathan Levine,72.1429,-62.433516,109.70938400000001
721,2013-12-25,August: Osage County 2013,25000000,37738810,50738810,13000000,25738810,2013,"Comedy,Drama",John Wells,50.95524,-48.0,102.95524
722,2014-05-16,Million Dollar Arm 2014,25000000,36447959,39217912,2769953,14217912,2014,"Biography,Drama,Sport",Craig Gillespie,45.791836,-88.920188,56.87164799999999
723,2018-09-07,Peppermint 2018,25000000,35418723,51800758,16382035,26800758,2018,"Action,Crime,Drama",Pierre Morel,41.674892,-34.47186,107.20303200000001
724,2014-12-10,The Gambler 2014,25000000,33680992,38718031,5037039,13718031,2014,"Crime,Drama,Thriller",Rupert Wyatt,34.723968,-79.851844,54.872124
725,2017-02-17,Fist Fight 2017,25000000,32187017,40286416,8099399,15286416,2017,Comedy,Richie Keen,28.748068,-67.602404,61.145664
726,2011-12-09,The Sitter 2011,25000000,30542576,38749404,8206828,13749404,2011,Comedy,David Gordon Green,22.170303999999998,-67.17268800000001,54.99761600000001
727,2014-04-11,Draft Day 2014,25000000,28842237,29847480,1005243,4847480,2014,"Drama,Sport",Ivan Reitman,15.368948,-95.979028,19.38992
728,2017-02-03,Rings 2017,25000000,27793018,82917283,55124265,57917283,2017,"Drama,Horror,Mystery",F. Javier GutiÃ©rrez,11.172072,120.49706,231.669132
730,2011-02-11,The Eagle 2011,25000000,19490041,38993548,19503507,13993548,2011,"Action,Adventure,Drama",Kevin Macdonald,-22.039835999999998,-21.985972,55.974192
731,2011-09-02,Shark Night 3D 2011,25000000,18877153,18877153,0,-6122847,2011,"Horror,Thriller",David R. Ellis,-24.491388,-100.0,-24.491388
732,2017-12-22,Father Figures 2017,25000000,17501244,21038441,3537197,-3961559,2017,"Adventure,Comedy,Drama",Lawrence Sher,-29.995023999999997,-85.851212,-15.846236
733,2013-10-25,The Counselor 2013,25000000,16973715,71009334,54035619,46009334,2013,"Crime,Drama,Thriller",Ridley Scott,-32.10514,116.142476,184.037336
734,2018-12-07,Mary Queen of Scots 2018,25000000,16468499,46734733,30266234,21734733,2018,"Biography,Drama,History",Josie Rourke,-34.126004,21.064936,86.93893200000001
736,2011-09-09,Warrior 2011,25000000,13657115,24215385,10558270,-784615,2011,"Drama,Sport",Gavin O'Connor,-45.371539999999996,-57.76692,-3.13846
737,2017-09-22,Battle of the Sexes 2017,25000000,12638526,18445379,5806853,-6554621,2017,"Biography,Comedy,Drama","Valerie Faris, Jonathan Dayton",-49.445896,-76.772588,-26.218483999999997
738,2012-12-21,Cirque du Soleil: Worlds Away 2012,25000000,12512862,28012862,15500000,3012862,2012,Fantasy,Andrew Adamson,-49.948552,-38.0,12.051447999999999
739,2015-11-13,The 33 2015,25000000,12227722,28400715,16172993,3400715,2015,"Biography,Drama,History",Patricia Riggen,-51.089112,-35.308028,13.60286
740,2011-09-16,Straw Dogs 2011,25000000,10324441,11253821,929380,-13746179,2011,"Action,Drama,Thriller",Rod Lurie,-58.702236,-96.28248,-54.984716
741,2019-01-25,Serenity 2019,25000000,8547045,11367029,2819984,-13632971,2019,"Drama,Mystery,Sci-Fi",Steven Knight,-65.81182,-88.720064,-54.531884
742,2018-10-12,Beautiful Boy 2018,25000000,7634767,13031424,5396657,-11968576,2018,"Biography,Drama",Felix van Groeningen,-69.460932,-78.41337200000001,-47.874304
743,2019-03-15,Captive State 2019,25000000,5958315,8993300,3034985,-16006700,2019,"Sci-Fi,Thriller",Rupert Wyatt,-76.16674,-87.86005999999999,-64.0268
744,2018-04-13,Sgt. Stubby: An American Hero 2018,25000000,3054285,3645957,591672,-21354043,2018,"Adventure,Animation,Family",Richard Lanni,-87.78286,-97.633312,-85.416172
745,2011-12-16,Carnage 2011,25000000,2546747,38112154,35565407,13112154,2011,"Comedy,Drama",Roman Polanski,-89.813012,42.261628,52.448616
746,2017-09-01,Tulip Fever 2017,25000000,2455635,6792768,4337133,-18207232,2017,"Drama,History,Romance",Justin Chadwick,-90.17746,-82.651468,-72.828928
747,2015-11-20,Legend 2015,25000000,1872994,42425450,40552456,17425450,2015,"Biography,Crime,Drama",Brian Helgeland,-92.508024,62.209824000000005,69.7018
748,2013-03-22,On the Road 2013,25000000,720828,9313302,8592474,-15686698,2013,Documentary,Marvin Dau,-97.116688,-65.630104,-62.746792
750,2011-07-08,Ironclad 2011,25000000,0,5297411,5297411,-19702589,2011,"Action,Adventure,Drama",Jonathan English,-100.0,-78.810356,-78.810356
751,2019-05-10,The Professor and the Madman 2019,25000000,0,5227233,5227233,-19772767,2019,"Biography,Drama,Mystery",Farhad Safinia,-100.0,-79.09106799999999,-79.09106799999999
752,2012-11-09,Dangerous Liaisons 2012,24200000,17000,10447579,10430579,-13752421,2012,"Drama,Mystery,Romance",Jin-ho Hur,-99.92975206611571,-56.89843388429752,-56.82818595041322
753,2014-06-20,Think Like a Man Too 2014,24000000,65028687,70027933,4999246,46027933,2014,"Comedy,Romance",Tim Story,170.95286249999998,-79.16980833333334,191.7830541666667
754,2016-12-16,Fences 2016,24000000,57682904,64282881,6599977,40282881,2016,Drama,Denzel Washington,140.34543333333335,-72.50009583333333,167.8453375
755,2011-10-14,Footloose 2011,24000000,51802742,62989834,11187092,38989834,2011,"Comedy,Drama,Music",Craig Brewer,115.84475833333335,-53.38711666666667,162.4576416666667
756,2017-04-07,Going in Style 2017,24000000,45018541,78672579,33654038,54672579,2017,"Comedy,Crime",Zach Braff,87.57725416666666,40.22515833333333,227.8024125
759,2011-09-16,I Don't Know How She Does It 2011,24000000,9659074,24474463,14815389,474463,2011,"Comedy,Romance",Douglas McGrath,-59.75385833333333,-38.2692125,1.9769291666666668
760,2013-12-20,Dhoom 3 2013,24000000,8031955,11723620,3691665,-12276380,2013,"Action,Thriller",Vijay Krishna Acharya,-66.53352083333334,-84.61806250000001,-51.15158333333333
761,2018-11-16,Green Book 2018,23000000,85080171,322034439,236954268,299034439,2018,"Biography,Comedy,Drama",Peter Farrelly,269.91378695652173,930.235947826087,1300.1497347826087
762,2015-01-16,The Wedding Ringer 2015,23000000,64460211,80171596,15711385,57171596,2015,Comedy,Jeremy Garelick,180.26178695652172,-31.689630434782607,248.57215652173915
763,2011-10-07,The Ides of March 2011,23000000,40962534,77735925,36773391,54735925,2011,"Drama,Thriller",George Clooney,78.09797391304349,59.88430869565218,237.98228260869564
764,2018-10-05,The Hate U Give 2018,23000000,29719483,35067665,5348182,12067665,2018,"Crime,Drama",George Tillman Jr.,29.21514347826087,-76.7470347826087,52.46810869565217
765,2013-06-28,Redemption 2013,23000000,36686,13593473,13556787,-9406527,2013,"Action,Crime,Drama",Steven Knight,-99.84049565217391,-41.05744782608696,-40.89794347826087
769,2016-11-18,Nocturnal Animals 2016,22500000,10663357,32398681,21735324,9898681,2016,"Drama,Thriller",Tom Ford,-52.607302222222216,-3.39856,43.99413777777777
770,2014-02-28,Son of God 2014,22000000,59700064,70949793,11249729,48949793,2014,"Biography,Drama,History",Christopher Spencer,171.36392727272727,-48.86486818181818,222.4990590909091
771,2014-08-08,The Hundred-Foot Journey 2014,22000000,54235441,94270488,40035047,72270488,2014,"Comedy,Drama",Lasse HallstrÃ¶m,146.5247318181818,81.97748636363636,328.5022181818182
772,2012-08-03,Diary of a Wimpy Kid: Dog Days 2012,22000000,49008662,77229695,28221033,55229695,2012,"Comedy,Family",David Bowers,122.76664545454545,28.27742272727273,251.0440681818182
773,2013-11-22,Delivery Man 2013,22000000,30659817,70536870,39877053,48536870,2013,"Comedy,Drama",Ken Scott,39.362804545454544,81.25933181818182,220.62213636363634
774,2016-02-05,"Hail, Caesar! 2016",22000000,30080225,64160680,34080455,42160680,2016,"Comedy,Drama,Music","Ethan Coen, Joel Coen",36.72829545454546,54.91115909090909,191.63945454545456
775,2017-05-19,Diary of a Wimpy Kid: The Long Haul 2017,22000000,20738724,35609577,14870853,13609577,2017,"Comedy,Family",David Bowers,-5.733072727272727,-32.40521363636364,61.86171363636363
776,2013-11-27,Homefront 2013,22000000,20158492,51695362,31536870,29695362,2013,"Action,Thriller",Gary Fleder,-8.37049090909091,43.34940909090909,134.9789181818182
778,2015-09-04,The Transporter Refueled 2015,22000000,16029670,69698495,53668825,47698495,2015,"Action,Adventure,Crime",Camille Delamarre,-27.137863636363633,143.94920454545453,216.81134090909092
779,2017-11-17,"Roman J. Israel, Esq. 2017",22000000,11962712,12967012,1004300,-9032988,2017,"Crime,Drama,Thriller",Dan Gilroy,-45.624036363636364,-95.435,-41.059036363636366
780,2013-12-04,Out of the Furnace 2013,22000000,11330849,15434375,4103526,-6565625,2013,"Crime,Drama,Thriller",Scott Cooper,-48.496140909090904,-81.34760909090909,-29.843750000000004
781,2017-12-08,Just Getting Started 2017,22000000,6069605,6756412,686807,-15243588,2017,"Action,Comedy",Ron Shelton,-72.41088636363637,-96.87814999999999,-69.28903636363636
782,2014-10-31,Before I Go to Sleep 2014,22000000,3242457,19563579,16321122,-2436421,2014,"Drama,Horror,Mystery",Rowan Joffe,-85.26155909090909,-25.813081818181814,-11.07464090909091
784,2012-06-22,To Rome with Love 2012,21500000,16684352,74326015,57641663,52826015,2012,"Comedy,Music,Romance",Woody Allen,-22.398362790697675,168.1007581395349,245.70239534883723
785,2012-11-16,Silver Linings Playbook 2012,21000000,132092958,236412453,104319495,215412453,2012,"Comedy,Drama,Romance",David O. Russell,529.0140857142857,396.7595,1025.7735857142857
786,2018-04-06,Blockers 2018,21000000,60311495,94045328,33733833,73045328,2018,Comedy,Kay Cannon,187.19759523809526,60.6373,347.8348952380952
787,2019-04-05,Pet Sematary 2019,21000000,54724696,109501146,54776450,88501146,2019,"Horror,Mystery,Thriller","Kevin KÃ¶lsch, Dennis Widmyer",160.59379047619046,160.84023809523808,421.4340285714286
790,2017-08-04,Kidnap 2017,21000000,30718107,34836080,4117973,13836080,2017,"Crime,Drama,Thriller",Luis Prieto,46.2767,-80.39060476190475,65.88609523809524
791,2011-12-09,Tinker Tailor Soldier Spy 2011,21000000,24149393,81452811,57303418,60452811,2011,"Drama,Mystery,Thriller",Tomas Alfredson,14.997109523809524,172.87341904761902,287.87052857142857
792,2011-05-06,The Beaver 2011,21000000,970816,5046038,4075222,-15953962,2011,Drama,Jodie Foster,-95.37706666666666,-80.59418095238095,-75.97124761904762
793,2017-02-24,Bitter Harvest 2017,21000000,557241,606162,48921,-20393838,2017,"Drama,Romance,War",George Mendeluk,-97.34647142857142,-99.76704285714287,-97.11351428571429
794,2019-02-01,Velvet Buzzsaw 2019,21000000,0,0,0,-21000000,2019,"Horror,Mystery,Thriller",Dan Gilroy,-100.0,-100.0,-100.0
795,2019-03-22,Us 2019,20000000,175006930,254210310,79203380,234210310,2019,"Horror,Mystery,Thriller",Jordan Peele,775.03465,296.0169,1171.05155
796,2016-12-09,La La Land 2016,20000000,151101803,426351163,275249360,406351163,2016,"Comedy,Drama,Music",Damien Chazelle,655.509015,1276.2468000000001,2031.755815
797,2013-07-19,The Conjuring 2013,20000000,137400141,318000141,180600000,298000141,2013,"Horror,Mystery,Thriller",James Wan,587.000705,802.9999999999999,1490.000705
798,2017-11-17,Wonder 2017,20000000,132422809,304604712,172181903,284604712,2017,"Drama,Family",Stephen Chbosky,562.114045,760.9095149999999,1423.02356
800,2016-07-29,Bad Moms 2016,20000000,113257297,180998716,67741419,160998716,2016,Comedy,"Jon Lucas, Scott Moore",466.286485,238.707095,804.9935800000001
801,2019-01-18,Glass 2019,20000000,111035005,245303505,134268500,225303505,2019,"Drama,Sci-Fi,Thriller",M. Night Shyamalan,455.17502500000006,571.3425,1126.517525
802,2014-07-02,Tammy 2014,20000000,84525432,96407655,11882223,76407655,2014,"Comedy,Romance",Ben Falcone,322.62716,-40.588885000000005,382.038275
803,2011-11-16,The Descendants 2011,20000000,82624961,175507800,92882839,155507800,2011,"Comedy,Drama",Alexander Payne,313.124805,364.414195,777.539
806,2013-10-18,12 Years a Slave 2013,20000000,56671993,181025343,124353350,161025343,2013,"Biography,Drama,History",Steve McQueen,183.359965,521.76675,805.1267149999999
807,2016-06-03,Me Before You 2016,20000000,56245075,208265198,152020123,188265198,2016,"Drama,Romance",Thea Sharrock,181.22537499999999,660.100615,941.32599
808,2019-02-08,What Men Want 2019,20000000,54611903,69911903,15300000,49911903,2019,"Comedy,Fantasy,Romance",Adam Shankman,173.059515,-23.5,249.55951500000003
809,2016-04-15,Barbershop: The Next Cut 2016,20000000,54030051,54404202,374151,34404202,2016,"Comedy,Drama",Malcolm D. Lee,170.15025500000002,-98.129245,172.02101000000002
810,2018-09-14,A Simple Favor 2018,20000000,53548586,97628717,44080131,77628717,2018,"Comedy,Crime,Drama",Paul Feig,167.74293,120.40065499999999,388.143585
811,2015-11-06,Spotlight 2015,20000000,45055776,92088460,47032684,72088460,2015,"Crime,Drama",Tom McCarthy,125.27888,135.16342,360.4423
813,2018-03-30,Acrimony 2018,20000000,43549096,46627836,3078740,26627836,2018,"Drama,Romance,Thriller",Tyler Perry,117.74548,-84.6063,133.13918
814,2015-06-26,Max 2015,20000000,42656255,43658157,1001902,23658157,2015,"Adventure,Drama,Family",Boaz Yakin,113.28127500000001,-94.99049000000001,118.29078500000001
815,2017-11-17,The Star 2017,20000000,40847995,62758010,21910015,42758010,2017,"Adventure,Animation,Comedy",Timothy Reckart,104.239975,9.550075,213.79005
816,2016-07-27,Nerve 2016,20000000,38583626,70652284,32068658,50652284,2016,"Action,Adventure,Crime","Henry Joost, Ariel Schulman",92.91813,60.34329,253.26142
817,2016-02-19,Risen 2016,20000000,36880033,46255763,9375730,26255763,2016,"Action,Adventure,Drama",Kevin Reynolds,84.400165,-53.12135,131.278815
820,2011-11-04,A Very Harold & Kumar 3D Christmas 2011,20000000,35061031,36265745,1204714,16265745,2011,"Adventure,Comedy",Todd Strauss-Schulson,75.305155,-93.97643,81.328725
821,2013-01-04,Texas Chainsaw 3D 2013,20000000,34341945,47666013,13324068,27666013,2013,"Horror,Thriller",John Luessenhop,71.709725,-33.37966,138.330065
823,2013-08-23,The World's End 2013,20000000,26004851,47508505,21503654,27508505,2013,"Action,Comedy,Sci-Fi",Edgar Wright,30.024255,7.51827,137.54252499999998
825,2018-12-25,On the Basis of Sex 2018,20000000,24622687,38073377,13450690,18073377,2018,"Biography,Drama",Mimi Leder,23.113435,-32.74655,90.366885
826,2014-02-14,Endless Love 2014,20000000,23438250,34718173,11279923,14718173,2014,"Drama,Romance",Shana Feste,17.19125,-43.600385,73.59086500000001
827,2011-07-01,Monte Carlo 2011,20000000,23186769,39686769,16500000,19686769,2011,"Adventure,Comedy,Family",Thomas Bezucha,15.933845,-17.5,98.43384499999999
828,2017-06-16,Rough Night 2017,20000000,22105643,46844357,24738714,26844357,2017,"Comedy,Crime,Thriller",Lucia Aniello,10.528215000000001,23.69357,134.22178499999998
829,2015-11-20,Secret in Their Eyes 2015,20000000,20180155,32608019,12427864,12608019,2015,"Crime,Drama,Mystery",Billy Ray,0.900775,-37.86068,63.040094999999994
830,2017-09-29,Flatliners 2017,20000000,16883115,45173738,28290623,25173738,2017,"Drama,Horror,Mystery",Niels Arden Oplev,-15.584425,41.453115000000004,125.86869
831,2012-04-13,Lockout 2012,20000000,14326865,33943049,19616184,13943049,2012,"Action,Sci-Fi,Thriller","James Mather, Steve Saint Leger",-28.365675000000003,-1.9190800000000001,69.71524500000001
832,2011-09-30,What's Your Number? 2011,20000000,14011084,30163785,16152701,10163785,2011,"Comedy,Romance",Mark Mylod,-29.94458,-19.236495,50.81892500000001
833,2015-10-30,Burnt 2015,20000000,13651946,36773510,23121564,16773510,2015,"Comedy,Drama",John Wells,-31.74027,15.60782,83.86755000000001
834,2016-02-26,Triple 9 2016,20000000,12639297,25943792,13304495,5943792,2016,"Crime,Thriller",John Hillcoat,-36.803515,-33.477525,29.71896
835,2016-09-02,The Light Between Oceans 2016,20000000,12545979,22281732,9735753,2281732,2016,"Drama,Romance",Derek Cianfrance,-37.270105,-51.321235,11.40866
837,2016-06-03,Popstar: Never Stop Never Stopping 2016,20000000,9496130,9537120,40990,-10462880,2016,"Comedy,Music","Akiva Schaffer, Jorma Taccone",-52.519349999999996,-99.79505,-52.314400000000006
838,2017-10-27,Thank You for Your Service 2017,20000000,9479390,9985316,505926,-10014684,2017,"Biography,Drama,War",Jason Hall,-52.603049999999996,-97.47036999999999,-50.07342
839,2013-09-20,Battle of the Year 2013,20000000,8888355,16723377,7835022,-3276623,2013,"Drama,Music",Benson Lee,-55.55822500000001,-60.824889999999996,-16.383115
840,2014-12-12,Inherent Vice 2014,20000000,8110975,14772346,6661371,-5227654,2014,"Comedy,Crime,Drama",Paul Thomas Anderson,-59.445125,-66.693145,-26.138270000000002
841,2013-10-11,Machete Kills 2013,20000000,8008161,18273009,10264848,-1726991,2013,"Action,Crime,Sci-Fi",Robert Rodriguez,-59.959195,-48.675760000000004,-8.634955
842,2015-04-24,Little Boy 2015,20000000,6485961,17769299,11283338,-2230701,2015,"Drama,History,War",Alejandro Monteverde,-67.570195,-43.58331,-11.153505
843,2012-10-26,Chasing Mavericks 2012,20000000,6002756,8300821,2298065,-11699179,2012,"Biography,Drama,Sport","Michael Apted, Curtis Hanson",-69.98622,-88.509675,-58.495895
844,2014-12-31,A Most Violent Year 2014,20000000,5749134,8846875,3097741,-11153125,2014,"Crime,Drama,Thriller",J.C. Chandor,-71.25433,-84.511295,-55.765625
845,2011-11-23,A Dangerous Method 2011,20000000,5702083,14807531,9105448,-5192469,2011,"Biography,Drama,Romance",David Cronenberg,-71.489585,-54.47276,-25.962345
846,2016-08-26,Hands of Stone 2016,20000000,4712792,5031975,319183,-14968025,2016,"Action,Biography,Drama",Jonathan Jakubowicz,-76.43604,-98.404085,-74.840125
847,2012-09-07,The Cold Light of Day 2012,20000000,3763583,25361206,21597623,5361206,2012,"Action,Thriller",Mabrouk El Mechri,-81.182085,7.988115,26.806029999999996
848,2018-10-26,Suspiria 2018,20000000,2483472,7034615,4551143,-12965385,2018,"Fantasy,Horror,Mystery",Luca Guadagnino,-87.58264,-77.244285,-64.826925
849,2015-11-13,My All-American 2015,20000000,2246000,2246000,0,-17754000,2015,"Biography,Drama,Sport",Angelo Pizzo,-88.77000000000001,-100.0,-88.77000000000001
852,2015-11-13,By the Sea 2015,20000000,538460,3727746,3189286,-16272254,2015,"Drama,Romance",Angelina Jolie,-97.3077,-84.05357,-81.36126999999999
855,2015-10-30,Regression 2015,20000000,55039,15824374,15769335,-4175626,2015,"Crime,Horror,Mystery",Alejandro AmenÃ¡bar,-99.724805,-21.153325000000002,-20.87813
856,2012-12-31,Zambezia 2012,20000000,0,34454336,34454336,14454336,2012,"Adventure,Animation,Comedy",Wayne Thornley,-100.0,72.27168,72.27168
857,2015-05-29,Survivor 2015,20000000,0,1703281,1703281,-18296719,2015,"Action,Crime,Thriller",James McTeigue,-100.0,-91.483595,-91.483595
858,2016-11-18,The History of Love 2016,20000000,0,476624,476624,-19523376,2016,"Drama,Romance,War",Radu Mihaileanu,-100.0,-97.61688,-97.61688
859,2014-08-29,Dwegons and Leprechauns 2014,20000000,0,0,0,-20000000,2014,Animation,Tom Walsh,-100.0,-100.0,-100.0
860,2016-07-22,Fight Valley 2016,20000000,0,0,0,-20000000,2016,"Action,Drama",Rob Hawk,-100.0,-100.0,-100.0
861,2018-12-13,Bird Box 2018,19800000,0,0,0,-19800000,2018,"Drama,Horror,Sci-Fi",Susanne Bier,-100.0,-100.0,-100.0
862,2017-12-01,The Shape of Water 2017,19500000,63859435,195790794,131931359,176290794,2017,"Adventure,Drama,Fantasy",Guillermo del Toro,227.48428205128204,576.5710717948717,904.0553538461538
863,2013-08-23,The Frozen Ground 2013,19200000,0,5617460,5617460,-13582540,2013,"Crime,Drama,Mystery",Scott Walker,-100.0,-70.74239583333333,-70.74239583333333
864,2011-07-29,The Devil's Double 2011,19100000,1361512,5965646,4604134,-13134354,2011,"Biography,Drama,Thriller",Lee Tamahori,-92.87166492146596,-75.89458638743456,-68.76625130890052
865,2011-06-24,Bad Teacher 2011,19000000,100292856,215448997,115156141,196448997,2011,"Comedy,Romance",Jake Kasdan,427.8571368421052,506.0849526315789,1033.942089473684
866,2016-08-12,Sausage Party 2016,19000000,97670358,141344255,43673897,122344255,2016,"Adventure,Animation,Comedy","Conrad Vernon, Greg Tiernan",414.05451578947367,129.8626157894737,643.9171315789474
871,2013-11-08,The Book Thief 2013,19000000,21488481,76086711,54598230,57086711,2013,"Drama,War",Brian Percival,13.097268421052632,187.3591052631579,300.4563736842105
872,2011-03-04,Take Me Home Tonight 2011,19000000,6928068,7576604,648536,-11423396,2011,"Comedy,Drama,Romance",Michael Dowse,-63.53648421052631,-96.58665263157896,-60.12313684210526
873,2012-09-28,Won't Back Down 2012,19000000,5310554,5745503,434949,-13254497,2012,Drama,Daniel Barnz,-72.0497157894737,-97.7107947368421,-69.76051052631578
874,2018-06-01,Action Point 2018,19000000,5059608,5103675,44067,-13896325,2018,Comedy,Tim Kirkby,-73.37048421052631,-99.76806842105263,-73.13855263157895
875,2014-05-09,Neighbors 2014,18000000,150086800,270944428,120857628,252944428,2014,Comedy,Nicholas Stoller,733.8155555555555,571.4312666666666,1405.2468222222221
876,2016-03-25,My Big Fat Greek Wedding 2 2016,18000000,59689605,92096558,32406953,74096558,2016,"Comedy,Romance",Kirk Jones,231.60891666666666,80.03862777777778,411.6475444444444
877,2015-09-11,The Perfect Guy 2015,18000000,57027435,60278166,3250731,42278166,2015,"Crime,Drama,Horror",David M. Rosenthal,216.81908333333334,-81.94038333333333,234.8787
878,2011-03-25,Diary of a Wimpy Kid: Rodrick Rules 2011,18000000,52698535,73695194,20996659,55695194,2011,"Comedy,Family",David Bowers,192.7696388888889,16.648105555555556,309.41774444444445
879,2011-04-08,Soul Surfer 2011,18000000,43853424,47158652,3305228,29158652,2011,"Biography,Drama,Family",Sean McNamara,143.63013333333333,-81.63762222222222,161.9925111111111
880,2018-06-29,Uncle Drew 2018,18000000,42469946,46527161,4057215,28527161,2018,"Comedy,Sport",Charles Stone III,135.94414444444445,-77.45991666666666,158.4842277777778
881,2014-10-17,Birdman or (The Unexpected Virtue of Ignorance) 2014,18000000,42340598,103215094,60874496,85215094,2014,"Comedy,Drama",Alejandro G. IÃ±Ã¡rritu,135.22554444444444,238.19164444444442,473.41718888888886
882,2013-07-26,Blue Jasmine 2013,18000000,33404871,102912961,69508090,84912961,2013,Drama,Woody Allen,85.58261666666667,286.15605555555555,471.7386722222222
883,2015-08-07,Ricki and the Flash 2015,18000000,26839498,41166033,14326535,23166033,2015,"Comedy,Drama,Music",Jonathan Demme,49.10832222222222,-20.40813888888889,128.70018333333334
884,2015-11-13,Love the Coopers 2015,18000000,26302731,42227490,15924759,24227490,2015,"Comedy,Fantasy,Romance",Jessie Nelson,46.12628333333333,-11.529116666666667,134.59716666666665
885,2017-04-28,The Circle 2017,18000000,20497844,40651864,20154020,22651864,2017,"Drama,Horror,Thriller",Peter Callow,13.876911111111113,11.966777777777777,125.84368888888888
889,2016-01-15,Norm of the North 2016,18000000,17062499,30535660,13473161,12535660,2016,"Adventure,Animation,Comedy",Trevor Wall,-5.208338888888889,-25.149105555555558,69.64255555555555
890,2013-08-16,Jobs 2013,18000000,16131410,43402515,27271105,25402515,2013,"Biography,Drama",Joshua Michael Stern,-10.381055555555555,51.506138888888884,141.12508333333332
891,2014-07-25,And So It Goes 2014,18000000,15160801,17920013,2759212,-79987,2014,"Comedy,Drama,Romance",Rob Reiner,-15.773327777777777,-84.67104444444445,-0.4443722222222222
892,2013-08-30,Getaway 2013,18000000,10501938,11813989,1312051,-6186011,2013,"Action,Crime,Thriller",Courtney Solomon,-41.6559,-92.71082777777778,-34.366727777777776
893,2016-03-18,Midnight Special 2016,18000000,3712282,7680250,3967968,-10319750,2016,"Action,Drama,Mystery",Jeff Nichols,-79.3762111111111,-77.95573333333333,-57.331944444444446
894,2016-11-25,Miss Sloane 2016,18000000,3500605,7719630,4219025,-10280370,2016,"Drama,Thriller",John Madden,-80.55219444444445,-76.56097222222222,-57.11316666666667
895,2013-09-27,Metallica Through the Never 2013,18000000,3419967,9082906,5662939,-8917094,2013,Music,NimrÃ³d Antal,-81.00018333333333,-68.53922777777778,-49.53941111111111
896,2013-03-01,Phantom 2013,18000000,1034589,1199510,164921,-16800490,2013,"Drama,History,Thriller",Todd Robinson,-94.25228333333334,-99.08377222222222,-93.33605555555555
898,2016-04-15,I Am Wrath 2016,18000000,0,309608,309608,-17690392,2016,"Action,Crime,Drama",Chuck Russell,-100.0,-98.27995555555556,-98.27995555555556
899,2014-11-14,Wolves 2014,18000000,0,94953,94953,-17905047,2014,"Action,Fantasy,Horror",David Hayter,-100.0,-99.47248333333333,-99.47248333333333
900,2014-08-22,The Prince 2014,18000000,0,0,0,-18000000,2014,"Action,Thriller",Brian A. Miller,-100.0,-100.0,-100.0
902,2016-02-19,Forsaken 2016,18000000,0,0,0,-18000000,2016,Horror,Justin Price,-100.0,-100.0,-100.0
903,2012-07-13,Red Lights 2012,17700000,49521,14518884,14469363,-3181116,2012,"Drama,Fantasy,Horror",Rodrigo CortÃ©s,-99.72022033898304,-18.252186440677967,-17.972406779661018
904,2013-11-27,Black Nativity 2013,17500000,7018188,7285135,266947,-10214865,2013,"Drama,Family,Music",Kasi Lemmons,-59.89606857142857,-98.47458857142857,-58.37065714285714
905,2018-04-06,A Quiet Place 2018,17000000,188024361,334522294,146497933,317522294,2018,"Drama,Horror,Sci-Fi",John Krasinski,1006.0256529411765,761.7525470588236,1867.7782
906,2013-11-15,The Best Man Holiday 2013,17000000,70525195,72835710,2310515,55835710,2013,"Comedy,Drama",Malcolm D. Lee,314.8540882352941,-86.40873529411765,328.44535294117645
907,2012-09-28,Pitch Perfect 2012,17000000,65001093,116044347,51043254,99044347,2012,"Comedy,Music,Romance",Jason Moore,282.35937058823527,200.25443529411766,582.613805882353
908,2013-04-05,Evil Dead 2013,17000000,54239856,97778356,43538500,80778356,2013,"Fantasy,Horror,Thriller",Fede Alvarez,219.05797647058822,156.10882352941175,475.16679999999997
909,2015-02-20,"McFarland, USA 2015",17000000,44480275,45707924,1227649,28707924,2015,"Biography,Drama,Sport",Niki Caro,161.6486764705882,-92.77853529411765,168.87014117647058
910,2016-11-11,Almost Christmas 2016,17000000,42065185,42493506,428321,25493506,2016,"Comedy,Drama",David E. Talbert,147.44226470588237,-97.48046470588235,149.96179999999998
911,2011-03-04,Beastly 2011,17000000,27865571,38028230,10162659,21028230,2011,"Drama,Fantasy,Romance",Daniel Barnz,63.915123529411765,-40.21965294117647,123.6954705882353
913,2012-08-24,The Apparition 2012,17000000,4936819,10637281,5700462,-6362719,2012,"Horror,Thriller",Todd Lincoln,-70.95988823529412,-66.46787058823529,-37.42775882352941
914,2016-06-10,Genius 2016,17000000,1361045,7265283,5904238,-9734717,2016,"Biography,Drama",Michael Grandage,-91.99385294117647,-65.26918823529412,-57.26304117647059
915,2019-07-12,Crawl 2019,17000000,0,0,0,-17000000,2019,"Action,Horror,Thriller",Alexandre Aja,-100.0,-100.0,-100.0
916,2016-03-11,The Young Messiah 2016,16800000,6469813,7313697,843884,-9486303,2016,"Drama,Fantasy",Cyrus Nowrasteh,-61.48920833333334,-94.97688095238095,-56.46608928571428
917,2012-05-25,Moonrise Kingdom 2012,16000000,45512466,68848446,23335980,52848446,2012,"Adventure,Comedy,Drama",Wes Anderson,184.4529125,45.849875000000004,330.3027875
918,2011-11-25,The Artist 2011,16000000,44667095,128256712,83589617,112256712,2011,"Comedy,Drama,Romance",Michel Hazanavicius,179.16934375,422.43510625000005,701.6044499999999
920,2011-02-04,The Roommate 2011,16000000,37300107,52545707,15245600,36545707,2011,"Drama,Thriller",Christian E. Christiansen,133.12566875000002,-4.715,228.41066875
922,2014-10-03,Left Behind 2014,16000000,14019924,20769209,6749285,4769209,2014,"Action,Drama,Fantasy",Vic Armstrong,-12.375475,-57.81696875,29.80755625
923,2012-06-29,People Like Us 2012,16000000,12431792,12617472,185680,-3382528,2012,"Comedy,Drama",Alex Kurtzman,-22.301299999999998,-98.8395,-21.140800000000002
924,2016-11-18,Bleed for This 2016,16000000,5083906,6603926,1520020,-9396074,2016,"Biography,Drama,Sport",Ben Younger,-68.22558749999999,-90.499875,-58.725462500000006
925,2014-11-14,The Homesman 2014,16000000,2429989,8217571,5787582,-7782429,2014,"Drama,Western",Tommy Lee Jones,-84.81256875,-63.8276125,-48.64018125
926,2013-04-05,Trance 2013,16000000,2322593,22594052,20271459,6594052,2013,"Crime,Drama,Mystery",Danny Boyle,-85.48379375,26.69661875,41.212824999999995
927,2012-11-02,Vamps 2012,16000000,3361,94812,91451,-15905188,2012,"Comedy,Horror,Romance",Amy Heckerling,-99.97899375,-99.42843125,-99.407425
928,2013-12-31,Zulu 2013,16000000,0,1844228,1844228,-14155772,2013,"Crime,Drama,Thriller",JÃ©rÃ´me Salle,-100.0,-88.47357500000001,-88.47357500000001
929,2018-12-21,Second Act 2018,15700000,39282227,63288854,24006627,47588854,2018,"Comedy,Drama,Romance",Peter Segal,150.20526751592357,52.908452229299364,303.11371974522297
930,2017-08-11,Annabelle: Creation 2017,15000000,102092201,305384865,203292664,290384865,2017,"Horror,Mystery,Thriller",David F. Sandberg,580.6146733333334,1255.2844266666666,1935.8990999999999
931,2014-11-28,The Imitation Game 2014,15000000,91125143,227740463,136615320,212740463,2014,"Biography,Drama,Thriller",Morten Tyldum,507.50095333333337,810.7687999999999,1418.2697533333335
932,2013-01-18,Mama 2013,15000000,71628180,148095566,76467386,133095566,2013,"Horror,Thriller",Andy Muschietti,377.52119999999996,409.7825733333333,887.3037733333333
934,2012-02-03,The Woman in Black 2012,15000000,54333290,128955898,74622608,113955898,2012,"Drama,Fantasy,Horror",James Watkins,262.2219333333333,397.48405333333335,759.7059866666667
935,2018-08-10,BlacKkKlansman 2018,15000000,49275340,93017335,43741995,78017335,2018,"Biography,Crime,Drama",Spike Lee,228.50226666666669,191.6133,520.1155666666667
936,2013-02-22,Snitch 2013,15000000,42930462,57907734,14977272,42907734,2013,"Action,Drama,Thriller",Ric Roman Waugh,186.20308,-0.15152,286.05156
937,2015-12-04,Krampus 2015,15000000,42725475,61788393,19062918,46788393,2015,"Comedy,Fantasy,Horror",Michael Dougherty,184.8365,27.08612,311.92262
938,2012-09-21,End of Watch 2012,15000000,41003371,57586606,16583235,42586606,2012,"Action,Crime,Drama",David Ayer,173.35580666666667,10.5549,283.91070666666667
939,2014-12-03,Wild 2014,15000000,37880356,52460543,14580187,37460543,2014,"Adventure,Biography,Drama",Jean-Marc VallÃ©e,152.53570666666667,-2.798753333333333,249.73695333333333
940,2014-11-07,The Theory of Everything 2014,15000000,35893537,123327692,87434155,108327692,2014,"Biography,Drama,Romance",James Marsh,139.29024666666666,482.89436666666666,722.1846133333333
941,2011-09-16,Drive 2011,15000000,35060689,81357930,46297241,66357930,2011,"Crime,Drama",Nicolas Winding Refn,133.73792666666665,208.64827333333332,442.3862
942,2018-11-23,The Favourite 2018,15000000,34366783,94113929,59747146,79113929,2018,"Biography,Drama,History",Yorgos Lanthimos,129.11188666666666,298.31430666666665,527.4261933333333
943,2014-08-22,When the Game Stands Tall 2014,15000000,30127963,30138912,10949,15138912,2014,"Drama,Family,Sport",Thomas Carter,100.85308666666666,-99.92700666666666,100.92608000000001
944,2017-09-08,Home Again 2017,15000000,27020284,37336874,10316590,22336874,2017,"Comedy,Drama,Romance",Hallie Meyers-Shyer,80.13522666666667,-31.222733333333334,148.91249333333334
946,2014-08-27,The November Man 2014,15000000,25018119,34820335,9802216,19820335,2014,"Action,Crime,Thriller",Roger Donaldson,66.78746,-34.651893333333334,132.13556666666665
947,2016-04-29,Keanu 2016,15000000,20591853,20688141,96288,5688141,2016,"Action,Comedy,Crime",Peter Atencio,37.27902,-99.35808,37.920939999999995
949,2014-07-25,A Most Wanted Man 2014,15000000,17237855,36068890,18831035,21068890,2014,"Crime,Drama,Thriller",Anton Corbijn,14.919033333333335,25.540233333333333,140.45926666666665
950,2012-11-02,The Man with the Iron Fists 2012,15000000,15634090,22018988,6384898,7018988,2012,Action,RZA,4.227266666666667,-57.43401333333333,46.79325333333333
951,2019-02-01,Miss Bala 2019,15000000,14998027,15362298,364271,362298,2019,"Action,Crime,Drama",Catherine Hardwicke,-0.013153333333333333,-97.57152666666667,2.41532
952,2012-11-30,Killing Them Softly 2012,15000000,14945541,39238443,24292902,24238443,2012,"Crime,Thriller",Andrew Dominik,-0.36306,61.95268,161.58962
953,2011-08-19,One Day 2011,15000000,13843771,59168692,45324921,44168692,2011,"Drama,Romance",Lone Scherfig,-7.708193333333334,202.16614,294.45794666666666
954,2016-09-23,Queen of Katwe 2016,15000000,8874389,10055481,1181092,-4944519,2016,"Biography,Drama,Sport",Mira Nair,-40.837406666666666,-92.12605333333333,-32.96346
955,2018-06-08,Hotel Artemis 2018,15000000,6708137,12758799,6050662,-2241201,2018,"Action,Drama,Sci-Fi",Drew Pearce,-55.279086666666664,-59.66225333333334,-14.94134
956,2015-10-30,Scouts Guide to the Zombie Apocalypse 2015,15000000,3703046,15554855,11851809,554855,2015,"Action,Comedy,Horror",Christopher Landon,-75.31302666666667,-20.98794,3.6990333333333334
958,2015-10-23,Rock the Kasbah 2015,15000000,3020665,3386153,365488,-11613847,2015,"Comedy,Music,War",Barry Levinson,-79.86223333333334,-97.56341333333334,-77.42564666666667
960,2016-09-09,The Disappointments Room 2016,15000000,2423467,3503761,1080294,-11496239,2016,"Drama,Horror,Thriller",D.J. Caruso,-83.84355333333333,-92.79804,-76.64159333333333
962,2011-11-04,The Son of No One 2011,15000000,30680,1148578,1117898,-13851422,2011,"Action,Crime,Drama",Dito Montiel,-99.79546666666667,-92.54734666666667,-92.34281333333332
963,2013-12-06,Khumba 2013,15000000,0,20898221,20898221,5898221,2013,"Adventure,Animation,Family",Anthony Silverston,-100.0,39.32147333333334,39.32147333333334
964,2015-09-01,Broken Horses 2015,15000000,0,3471,3471,-14996529,2015,"Action,Crime,Drama",Vidhu Vinod Chopra,-100.0,-99.97686,-99.97686
965,2019-08-14,Blinded by the Light 2019,15000000,0,0,0,-15000000,2019,"Biography,Comedy,Drama",Gurinder Chadha,-100.0,-100.0,-100.0
966,2015-07-01,Magic Mike XXL 2015,14500000,66013057,123660597,57647540,109160597,2015,"Comedy,Drama,Music",Gregory Jacobs,355.2624620689655,297.5692413793103,752.8317034482758
967,2012-08-31,The Possession 2012,14000000,49130588,82925064,33794476,68925064,2012,"Horror,Mystery,Thriller",Ole Bornedal,250.93277142857144,141.38911428571427,492.32188571428577
969,2015-02-20,Hot Tub Time Machine 2 2015,14000000,12314651,12826644,511993,-1173356,2015,"Comedy,Mystery,Sci-Fi",Steve Pink,-12.038207142857143,-96.34290714285714,-8.381114285714286
970,2012-10-26,Fun Size 2012,14000000,9409538,11166615,1757077,-2833385,2012,"Adventure,Comedy",Josh Schwartz,-32.78901428571429,-87.44945,-20.238464285714286
971,2015-10-23,Suffragette 2015,14000000,4702420,34044909,29342489,20044909,2015,"Biography,Drama,History",Sarah Gavron,-66.41128571428571,109.58920714285713,143.1779214285714
972,2014-12-19,Mr. Turner 2014,14000000,3958546,25187026,21228480,11187026,2014,"Biography,Drama,History",Mike Leigh,-71.72467142857143,51.632,79.90732857142856
974,2011-09-30,Margaret 2011,14000000,47185,623292,576107,-13376708,2011,Drama,Kenneth Lonergan,-99.66296428571428,-95.88495,-95.54791428571428
975,2012-10-12,Seven Psychopaths 2012,13500000,15024049,33035736,18011687,19535736,2012,"Comedy,Crime",Martin McDonagh,11.289251851851851,33.4199037037037,144.70915555555555
976,2014-09-12,No Good Deed 2014,13200000,52543632,54323210,1779578,41123210,2014,"Action,Crime,Drama",Sam Miller,298.05781818181816,-86.51834848484849,311.53946969696966
978,2011-02-11,Justin Bieber: Never Say Never 2011,13000000,73013910,99034125,26020215,86034125,2011,"Documentary,Music",Jon M. Chu,461.6454615384615,100.1555,661.8009615384615
979,2018-07-04,The First Purge 2018,13000000,69488745,136617305,67128560,123617305,2018,"Action,Horror,Sci-Fi",Gerard McMurray,434.5288076923077,416.3735384615385,950.9023461538461
980,2016-03-16,Miracles from Heaven 2016,13000000,61705123,73798736,12093613,60798736,2016,"Biography,Drama,Family",Patricia Riggen,374.6547923076923,-6.972207692307693,467.68258461538466
981,2016-06-24,The Shallows 2016,13000000,55121623,118763442,63641819,105763442,2016,"Drama,Horror,Thriller",Jaume Collet-Serra,324.0124846153846,389.55245384615387,813.5649384615384
982,2014-02-14,About Last Night 2014,13000000,48637684,50445860,1808176,37445860,2014,"Comedy,Romance",Steve Pink,274.1360307692308,-86.09095384615385,288.0450769230769
983,2014-10-10,St. Vincent 2014,13000000,44137712,54837234,10699522,41837234,2014,"Comedy,Drama",Theodore Melfi,239.52086153846156,-17.695984615384617,321.82487692307694
984,2014-07-02,Earth to Echo 2014,13000000,38934842,42174545,3239703,29174545,2014,"Adventure,Family,Sci-Fi",Dave Green,199.4987846153846,-75.07920769230769,224.41957692307693
985,2013-03-22,Admission 2013,13000000,18007317,18733666,726349,5733666,2013,"Comedy,Drama,Romance",Paul Weitz,38.51782307692307,-94.4127,44.10512307692308
986,2012-09-21,The Perks of Being a Wallflower 2012,13000000,17742948,33069303,15326355,20069303,2012,Drama,Stephen Chbosky,36.48421538461539,17.895038461538462,154.37925384615386
987,2015-10-16,Room 2015,13000000,14677674,36262783,21585109,23262783,2015,"Drama,Thriller",Lenny Abrahamson,12.905184615384616,66.0393,178.94448461538462
988,2015-10-16,Woodlawn 2015,13000000,14394097,14403703,9606,1403703,2015,"Drama,Sport","Andrew Erwin, Jon Erwin",10.723823076923077,-99.9261076923077,10.797715384615385
989,2015-07-17,Bajrangi Bhaijaan 2015,13000000,8178001,121778347,113600346,108778347,2015,"Action,Comedy,Drama",Kabir Khan,-37.0923,773.8488153846154,836.7565153846155
990,2015-12-04,Youth 2015,13000000,2703296,24001573,21298277,11001573,2015,"Comedy,Drama,Music",Paolo Sorrentino,-79.20541538461538,63.8329,84.62748461538462
991,2015-07-24,The Vatican Tapes 2015,13000000,1784763,14929184,13144421,1929184,2015,"Horror,Thriller",Mark Neveldine,-86.27105384615385,1.1109307692307693,14.839876923076922
992,2011-07-29,Attack the Block 2011,13000000,1024175,6459183,5435008,-6540817,2011,"Action,Comedy,Sci-Fi",Joe Cornish,-92.12173076923077,-58.19224615384615,-50.31397692307692
993,2015-08-14,Brothers 2015,13000000,656688,17856688,17200000,4856688,2015,Documentary,Aslaug Holm,-94.94855384615384,32.30769230769231,37.35913846153846
997,2013-03-15,The Call 2013,12800000,51872378,69821476,17949098,57021476,2013,"Crime,Drama,Horror",Brad Anderson,305.252953125,40.227328125,445.48028124999996
999,2014-09-12,The Drop 2014,12600000,10724389,19054534,8330145,6454534,2014,"Crime,Drama",MichaÃ«l R. Roskam,-14.885801587301586,-33.8877380952381,51.22646031746032
1003,2012-10-05,The Paperboy 2012,12500000,677200,4027663,3350463,-8472337,2012,"Crime,Drama,Mystery",Lee Daniels,-94.5824,-73.196296,-67.77869600000001
1004,2014-06-06,The Fault in Our Stars 2014,12000000,124872350,307166834,182294484,295166834,2014,"Drama,Romance",Josh Boone,940.6029166666666,1419.1207,2459.7236166666667
1005,2012-04-20,Think Like a Man 2012,12000000,91547205,113373764,21826559,101373764,2012,"Comedy,Romance",Tim Story,662.893375,81.88799166666666,844.7813666666667
1006,2012-02-24,Act of Valor 2012,12000000,70012847,82497035,12484188,70497035,2012,"Action,Adventure,Drama","Scott Waugh, Mike McCoy",483.4403916666667,4.0349,587.4752916666667
1007,2012-02-03,Chronicle 2012,12000000,64575175,123681790,59106615,111681790,2012,"Drama,Sci-Fi,Thriller",Josh Trank,438.12645833333335,392.555125,930.6815833333334
1008,2012-03-02,Project X 2012,12000000,54731865,103028188,48296323,91028188,2012,Comedy,Nima Nourizadeh,356.098875,302.46935833333333,758.5682333333334
1009,2017-11-10,"Three Billboards Outside Ebbing, Missouri 2017",12000000,54513740,160191915,105678175,148191915,2017,"Crime,Drama",Martin McDonagh,354.28116666666665,780.6514583333334,1234.9326250000001
1010,2016-11-25,Lion 2016,12000000,51739495,149570720,97831225,137570720,2016,"Biography,Drama",Garth Davis,331.16245833333335,715.2602083333333,1146.4226666666666
1011,2018-05-04,Overboard 2018,12000000,50316123,85369830,35053707,73369830,2018,"Comedy,Romance",Rob Greenberg,319.301025,192.114225,611.41525
1012,2013-11-22,Philomena 2013,12000000,37709979,98963392,61253413,86963392,2013,"Biography,Comedy,Drama",Stephen Frears,214.24982500000002,410.44510833333334,724.6949333333333
1013,2015-07-24,Paper Towns 2015,12000000,32000304,85450484,53450180,73450484,2015,"Comedy,Drama,Mystery",Jake Schreier,166.66920000000002,345.41816666666665,612.0873666666666
1014,2016-08-12,Hell or High Water 2016,12000000,27007844,37584304,10576460,25584304,2016,"Action,Crime,Drama",David Mackenzie,125.06536666666668,-11.862833333333334,213.20253333333335
1015,2012-07-05,Katy Perry: Part of Me 2012,12000000,25326071,32700439,7374368,20700439,2012,"Documentary,Music","Jane Lipsitz, Dan Cutforth",111.05059166666666,-38.546933333333335,172.50365833333333
1016,2014-12-12,Top Five 2014,12000000,25317379,26001741,684362,14001741,2014,"Comedy,Romance",Chris Rock,110.97815833333333,-94.29698333333333,116.681175
1017,2015-01-30,Project Almanac 2015,12000000,22348241,32909437,10561196,20909437,2015,"Drama,Mystery,Sci-Fi",Dean Israelite,86.23534166666667,-11.990033333333333,174.24530833333333
1019,2013-11-15,Nebraska 2013,12000000,17654912,24761360,7106448,12761360,2013,"Adventure,Comedy,Drama",Alexander Payne,47.124266666666664,-40.7796,106.34466666666667
1020,2011-12-09,Young Adult 2011,12000000,16311571,22750356,6438785,10750356,2011,"Comedy,Drama",Jason Reitman,35.92975833333333,-46.34345833333333,89.5863
1021,2013-11-01,About Time 2013,12000000,15323921,89309178,73985257,77309178,2013,"Comedy,Drama,Fantasy",Richard Curtis,27.699341666666665,516.5438083333333,644.24315
1022,2018-12-14,If Beale Street Could Talk 2018,12000000,14915773,19859167,4943394,7859167,2018,"Drama,Romance",Barry Jenkins,24.29810833333333,-58.80505,65.49305833333334
1023,2017-07-14,Wish Upon 2017,12000000,14301505,23477345,9175840,11477345,2017,"Drama,Fantasy,Horror",John R. Leonetti,19.179208333333335,-23.534666666666666,95.64454166666667
1024,2017-04-21,Unforgettable 2017,12000000,11368012,16221211,4853199,4221211,2017,"Drama,Thriller",Denise Di Novi,-5.266566666666667,-59.556675000000006,35.17675833333334
1025,2017-10-13,Marshall 2017,12000000,10051659,10116816,65157,-1883184,2017,"Biography,Crime,Drama",Reginald Hudlin,-16.236175,-99.457025,-15.6932
1026,2012-09-14,Arbitrage 2012,12000000,7919574,35830713,27911139,23830713,2012,"Drama,Thriller",Nicholas Jarecki,-34.00355,132.592825,198.58927500000001
1027,2012-06-01,For Greater Glory: The True Story of Cristiada 2012,12000000,5669081,10026255,4357174,-1973745,2012,"Drama,History,War",Dean Wright,-52.75765833333333,-63.690216666666664,-16.447875
1028,2013-03-01,Stoker 2013,12000000,1703125,12034913,10331788,34913,2013,"Drama,Thriller",Chan-wook Park,-85.80729166666666,-13.901766666666667,0.29094166666666665
1029,2011-03-11,Kill the Irishman 2011,12000000,1188194,1188194,0,-10811806,2011,"Biography,Crime,Drama",Jonathan Hensleigh,-90.09838333333333,-100.0,-90.09838333333333
1030,2012-04-20,Darling Companion 2012,12000000,793352,1200346,406994,-10799654,2012,"Comedy,Drama,Romance",Lawrence Kasdan,-93.38873333333333,-96.60838333333334,-89.99711666666667
1031,2015-10-09,Trash 2015,12000000,17484,6553186,6535702,-5446814,2015,Drama,Hajime Gonno,-99.8543,-45.53581666666667,-45.39011666666667
1032,2011-08-19,5 Days of War 2011,12000000,17479,87793,70314,-11912207,2011,"Action,Drama,War",Renny Harlin,-99.85434166666667,-99.41405,-99.26839166666667
1033,2015-11-11,10 Days in a Madhouse 2015,12000000,14616,14616,0,-11985384,2015,Drama,Timothy Hines,-99.87819999999999,-100.0,-99.87819999999999
1034,2014-10-03,Drive Hard 2014,12000000,0,0,0,-12000000,2014,"Action,Comedy,Crime",Brian Trenchard-Smith,-100.0,-100.0,-100.0
1035,2015-11-20,Carol 2015,11800000,12711491,42843521,30132030,31043521,2015,"Drama,Romance",Todd Haynes,7.724499999999999,155.35618644067796,263.080686440678
1036,2016-01-22,Dirty Grandpa 2016,11500000,35593113,105078449,69485336,93578449,2016,Comedy,Dan Mazer,209.50533043478262,504.22031304347826,813.7256434782608
1038,2014-08-22,If I Stay 2014,11000000,50474843,78356170,27881327,67356170,2014,"Drama,Fantasy,Music",R.J. Cutler,358.8622090909091,153.4666090909091,612.3288181818182
1039,2015-11-04,Brooklyn 2015,11000000,38322743,62076141,23753398,51076141,2015,"Drama,Romance",John Crowley,248.38857272727273,115.93998181818182,464.3285545454545
1040,2015-04-01,Woman in Gold 2015,11000000,33307793,58586407,25278614,47586407,2015,"Biography,Drama,History",Simon Curtis,202.79811818181818,129.80558181818182,432.60370000000006
1041,2017-12-08,"I, Tonya 2017",11000000,30014534,53797409,23782875,42797409,2017,"Biography,Comedy,Drama",Craig Gillespie,172.8594,116.20795454545454,389.0673545454546
1042,2013-12-06,Inside Llewyn Davis 2013,11000000,13248209,32943247,19695038,21943247,2013,"Drama,Music","Ethan Coen, Joel Coen",20.438263636363637,79.0458,199.48406363636363
1043,2013-05-10,Peeples 2013,11000000,9177065,9307166,130101,-1692834,2013,"Comedy,Romance",Tina Gordon,-16.572136363636364,-98.81726363636363,-15.3894
1044,2016-07-06,Sultan 2016,11000000,5599781,72989781,67390000,61989781,2016,"Action,Drama,Sport",Ali Abbas Zafar,-49.0929,512.6363636363636,563.5434636363636
1045,2012-05-04,LOL 2012,11000000,0,10431506,10431506,-568494,2012,"Comedy,Drama,Romance",Lisa Azuelos,-100.0,-5.168127272727273,-5.168127272727273
1046,2016-02-05,Misconduct 2016,11000000,0,2352511,2352511,-8647489,2016,"Crime,Drama,Mystery",Shintaro Shimosawa,-100.0,-78.61353636363636,-78.61353636363636
1047,2019-12-31,Eli 2019,11000000,0,0,0,-11000000,2019,Horror,CiarÃ¡n Foy,-100.0,-100.0,-100.0
1048,2013-12-06,The Last Days on Mars 2013,10600000,24084,261364,237280,-10338636,2013,"Adventure,Horror,Sci-Fi",Ruairi Robinson,-99.77279245283019,-97.76150943396227,-97.53430188679245
1050,2018-10-19,Halloween 2018,10000000,159342015,254900667,95558652,244900667,2018,"Horror,Thriller",David Gordon Green,1493.42015,855.58652,2449.0066699999998
1051,2016-07-01,The Purge: Election Year 2016,10000000,79042440,118514727,39472287,108514727,2016,"Action,Horror,Sci-Fi",James DeMonaco,690.4244,294.72287,1085.14727
1052,2018-05-18,Book Club 2018,10000000,68566296,91113683,22547387,81113683,2018,"Comedy,Drama,Romance",Bill Holderman,585.66296,125.47387,811.13683
1053,2018-01-05,Insidious: The Last Key 2018,10000000,67745330,167885588,100140258,157885588,2018,"Horror,Mystery,Thriller",Adam Robitel,577.4533,901.4025800000001,1578.85588
1054,2017-11-03,Lady Bird 2017,10000000,48958273,78610769,29652496,68610769,2017,"Comedy,Drama",Greta Gerwig,389.58273,196.52496,686.1076899999999
1055,2018-06-08,Hereditary 2018,10000000,44069456,70133905,26064449,60133905,2018,"Drama,Horror,Mystery",Ari Aster,340.69455999999997,160.64449000000002,601.33905
1056,2018-03-16,"Love, Simon 2018",10000000,40826341,65520633,24694292,55520633,2018,"Comedy,Drama,Romance",Greg Berlanti,308.26341,146.94292,555.20633
1057,2017-10-27,Jigsaw 2017,10000000,38052832,102445196,64392364,92445196,2017,"Crime,Horror,Mystery","Peter Spierig, Michael Spierig",280.52832,543.9236400000001,924.45196
1058,2016-01-22,The Boy 2016,10000000,35819556,68220952,32401396,58220952,2016,"Horror,Mystery,Thriller",William Brent Bell,258.19556,224.01396,582.20952
1059,2017-05-19,"Everything, Everything 2017",10000000,34121140,61603136,27481996,51603136,2017,"Drama,Romance",Stella Meghie,241.2114,174.81996,516.0313600000001
1061,2015-03-06,The Second Best Exotic Marigold Hotel 2015,10000000,33078266,90384306,57306040,80384306,2015,"Comedy,Drama",John Madden,230.78266,473.06039999999996,803.84306
1062,2017-04-28,How to Be a Latin Lover 2017,10000000,32149404,62556228,30406824,52556228,2017,"Comedy,Drama",Ken Marino,221.49404,204.06824,525.56228
1063,2018-08-10,Slender Man 2018,10000000,30564825,51723644,21158819,41723644,2018,"Horror,Mystery,Thriller",Sylvain White,205.64825,111.58819,417.23644
1064,2016-09-09,When the Bough Breaks 2016,10000000,29747603,30768449,1020846,20768449,2016,"Crime,Drama,Horror",Jon Cassar,197.47603,-89.79154,207.68449
1065,2015-08-21,Sinister 2 2015,10000000,27740955,54104225,26363270,44104225,2015,"Horror,Mystery,Thriller",CiarÃ¡n Foy,177.40955,163.6327,441.04225
1066,2016-01-08,The Forest 2016,10000000,26594261,40749230,14154969,30749230,2016,"Horror,Mystery,Thriller",Jason Zada,165.94261,41.54969,307.4923
1068,2012-08-17,Sparkle 2012,10000000,24397469,24660323,262854,14660323,2012,"Drama,Music",Salim Akil,143.97469,-97.37146,146.60323
1069,2016-10-14,Kevin Hart: What Now? 2016,10000000,23591043,23591043,0,13591043,2016,"Comedy,Documentary","Tim Story, Leslie Small",135.91043,-100.0,135.91043
1071,2017-12-01,The Disaster Artist 2017,10000000,21120616,28717667,7597051,18717667,2017,"Biography,Comedy,Drama",James Franco,111.20616000000001,-24.02949,187.17667
1072,2016-09-16,Blair Witch 2016,10000000,20777061,38985577,18208516,28985577,2016,"Horror,Mystery,Thriller",Adam Wingard,107.77060999999999,82.08516,289.85577
1073,2015-10-23,Paranormal Activity: The Ghost Dimension 2015,10000000,18297124,77959374,59662250,67959374,2015,"Horror,Mystery,Thriller",Gregory Plotkin,82.97124,496.62249999999995,679.59374
1074,2016-10-07,The Birth of a Nation 2016,10000000,15861566,16891011,1029445,6891011,2016,"Biography,Drama,History",Nate Parker,58.615660000000005,-89.70555,68.91011
1075,2011-11-23,My Week with Marilyn 2011,10000000,14597405,34240572,19643167,24240572,2011,"Biography,Drama",Simon Curtis,45.97405,96.43167,242.40572
1076,2014-12-25,Big Eyes 2014,10000000,14482031,27317872,12835841,17317872,2014,"Biography,Crime,Drama",Tim Burton,44.82031,28.35841,173.17872
1077,2019-04-05,The Best of Enemies 2019,10000000,10205616,10205616,0,205616,2019,"Biography,Drama,History",Robin Bissell,2.0561599999999998,-100.0,2.0561599999999998
1078,2013-01-25,Movie 43 2013,10000000,8840453,31164747,22324294,21164747,2013,Comedy,"James Gunn, Brett Ratner, Peter Farrelly, Elizabeth Banks, James Duffy, Patrik Forsberg, Will Graham, Steven Brill, Steve Carr, Rusty Cundieff, Griffin Dunne, Jonathan van Tulleken, Bob Odenkirk",-11.595469999999999,123.24294,211.64747
1079,2018-10-19,Can You Ever Forgive Me? 2018,10000000,8803865,11752387,2948522,1752387,2018,"Biography,Comedy,Crime",Marielle Heller,-11.96135,-70.51478,17.52387
1081,2012-06-22,Seeking a Friend for the End of the World 2012,10000000,7078738,11766959,4688221,1766959,2012,"Adventure,Comedy,Drama",Lorene Scafaria,-29.21262,-53.11779,17.66959
1082,2016-11-11,Shut In 2016,10000000,6900335,11360665,4460330,1360665,2016,"Drama,Mystery,Thriller",Farren Blackburn,-30.99665,-55.396699999999996,13.60665
1083,2011-02-11,Cedar Rapids 2011,10000000,6861102,7862131,1001029,-2137869,2011,Comedy,Miguel Arteta,-31.38898,-89.98971,-21.37869
1084,2012-11-30,The Collection 2012,10000000,6810754,8890094,2079340,-1109906,2012,"Action,Horror,Thriller",Marcus Dunstan,-31.89246,-79.20660000000001,-11.09906
1085,2015-03-20,Danny Collins 2015,10000000,5637066,8465845,2828779,-1534155,2015,"Biography,Comedy,Drama",Dan Fogelman,-43.62934,-71.71221,-15.341550000000002
1086,2018-06-15,Gotti 2018,10000000,4286367,6089100,1802733,-3910900,2018,"Biography,Crime,Drama",Kevin Connolly,-57.13633,-81.97267000000001,-39.109
1087,2016-09-30,Denial 2016,10000000,4073448,9263940,5190492,-736060,2016,"Biography,Drama",Mick Jackson,-59.26552,-48.09508,-7.360600000000001
1089,2016-10-14,Max Steel 2016,10000000,3818664,4563080,744416,-5436920,2016,"Action,Adventure,Family",Stewart Hendler,-61.813359999999996,-92.55584,-54.36919999999999
1090,2014-11-14,Rosewater 2014,10000000,3128941,3185717,56776,-6814283,2014,"Biography,Drama",Jon Stewart,-68.71059000000001,-99.43224000000001,-68.14283
1091,2011-09-09,Bucky Larson: Born to Be a Star 2011,10000000,2529395,2529395,0,-7470605,2011,Comedy,Tom Brady,-74.70605,-100.0,-74.70605
1092,2011-06-24,A Better Life 2011,10000000,1759252,1884251,124999,-8115749,2011,"Drama,Romance",Chris Weitz,-82.40747999999999,-98.75001,-81.15749
1094,2017-06-02,Churchill 2017,10000000,1279681,7582196,6302515,-2417804,2017,"Biography,Drama,History",Jonathan Teplitzky,-87.20318999999999,-36.974849999999996,-24.17804
1095,2014-03-21,50 to 1 2014,10000000,1069454,1069454,0,-8930546,2014,Drama,Jim Wilson,-89.30546,-100.0,-89.30546
1096,2013-10-04,Parkland 2013,10000000,641439,1616353,974914,-8383647,2013,"Drama,History,Mystery",Peter Landesman,-93.58561,-90.25086,-83.83646999999999
1097,2013-05-03,"Cinco de Mayo, La Batalla 2013",10000000,173472,173472,0,-9826528,2013,"Drama,History,War",Rafa Lara,-98.26528,-100.0,-98.26528
1099,2016-09-09,Kicks 2016,10000000,150191,150191,0,-9849809,2016,"Adventure,Drama",Justin Tipping,-98.49809,-100.0,-98.49809
1101,2014-11-07,Elsa & Fred 2014,10000000,67657,197901,130244,-9802099,2014,"Comedy,Drama,Romance",Michael Radford,-99.32343,-98.69756,-98.02099
1102,2015-07-10,Strangerland 2015,10000000,17472,161097,143625,-9838903,2015,"Drama,Mystery,Thriller",Kim Farrant,-99.82528,-98.56375,-98.38903
1103,2014-12-26,Barbecue 2014,10000000,388,247565,247177,-9752435,2014,Comedy,Eric Lavaine,-99.99612,-97.52823000000001,-97.52435
1106,2014-09-26,Plastic 2014,10000000,0,575371,575371,-9424629,2014,"Action,Comedy,Crime",Julian Gilbey,-100.0,-94.24629,-94.24629
1107,2012-04-13,Detention 2012,10000000,0,0,0,-10000000,2012,Horror,Richy Salgado,-100.0,-100.0,-100.0
1108,2015-05-19,Into the Grizzly Maze 2015,10000000,0,0,0,-10000000,2015,"Action,Adventure,Drama",David Hackl,-100.0,-100.0,-100.0
1110,2012-12-19,Amour 2012,9700000,6738954,36787044,30048090,27087044,2012,"Drama,Romance",Michael Haneke,-30.526247422680413,209.7741237113402,279.24787628865977
1111,2016-12-21,Dangal 2016,9500000,12391761,294654618,282262857,285154618,2016,"Action,Biography,Drama",Nitesh Tiwari,30.439589473684208,2871.1879684210526,3001.627557894737
1113,2011-11-11,Melancholia 2011,9400000,3030848,21817298,18786450,12417298,2011,"Drama,Sci-Fi",Lars von Trier,-67.75693617021277,99.85585106382979,132.09891489361704
1114,2012-11-13,Jab Tak Hai Jaan 2012,9200000,3047539,5806666,2759127,-3393334,2012,"Drama,Romance",Yash Chopra,-66.87457608695652,-70.00948913043479,-36.8840652173913
1116,2011-12-31,Red Dog 2011,9100000,0,20927794,20927794,11827794,2011,"Biography,Comedy,Drama",Kriv Stenders,-100.0,129.97575824175826,129.97575824175826
1117,2014-07-18,The Purge: Anarchy 2014,9000000,71562550,111534881,39972331,102534881,2014,"Action,Horror,Sci-Fi",James DeMonaco,695.1394444444444,344.1370111111111,1139.2764555555555
1118,2016-10-21,Ouija: Origin of Evil 2016,9000000,35144505,81831866,46687361,72831866,2016,"Drama,Horror,Mystery",Mike Flanagan,290.4945,418.74845555555555,809.2429555555557
1119,2019-02-13,Happy Death Day 2U 2019,9000000,28051045,64179495,36128450,55179495,2019,"Drama,Horror,Mystery",Christopher Landon,211.6782777777778,301.4272222222222,613.1055
1120,2016-11-18,The Edge of Seventeen 2016,9000000,14431633,19096003,4664370,10096003,2016,"Comedy,Drama",Kelly Fremon Craig,60.351477777777774,-48.17366666666666,112.17781111111111
1121,2016-12-02,Jackie 2016,9000000,13960394,36588512,22628118,27588512,2016,"Biography,Drama,History",Pablo LarraÃ­n,55.11548888888888,151.42353333333332,306.53902222222223
1122,2011-08-12,Glee: The 3D Concert Movie 2011,9000000,11862398,17462398,5600000,8462398,2011,"Documentary,Music","Jennifer Arnold, Kevin Tancharoen",31.80442222222222,-37.77777777777778,94.02664444444444
1123,2016-11-04,Loving 2016,9000000,7710234,12898064,5187830,3898064,2016,"Biography,Drama,Romance",Jeff Nichols,-14.330733333333335,-42.35744444444444,43.311822222222226
1124,2016-08-26,Greater 2016,9000000,2000093,2000093,0,-6999907,2016,"Biography,Family,Sport",David L. Hunt,-77.77674444444445,-100.0,-77.77674444444445
1125,2018-12-25,Destroyer 2018,9000000,1533324,3681096,2147772,-5318904,2018,"Action,Crime,Drama",Karyn Kusama,-82.96306666666666,-76.13586666666666,-59.098933333333335
1126,2015-11-13,Heist 2015,8900000,50136,3324131,3273995,-5575869,2015,"Action,Crime,Thriller",Scott Mann,-99.43667415730337,-63.213539325842696,-62.65021348314607
1128,2016-11-18,Manchester by the Sea 2016,8500000,47695371,77733867,30038496,69233867,2016,Drama,Kenneth Lonergan,461.12201176470586,253.39407058823528,814.5160823529412
1129,2014-10-31,Nightcrawler 2014,8500000,32381218,50334418,17953200,41834418,2014,"Crime,Drama,Thriller",Dan Gilroy,280.95550588235295,111.21411764705881,492.16962352941175
1130,2013-09-27,Baggage Claim 2013,8500000,21569509,22885836,1316327,14385836,2013,Comedy,David E. Talbert,153.7589294117647,-84.51379999999999,169.2451294117647
1131,2016-10-07,Middle School: The Worst Years of My Life 2016,8500000,20007149,23311293,3304144,14811293,2016,"Comedy,Family",Steve Carr,135.37822352941177,-61.12771764705882,174.25050588235294
1132,2014-06-13,The Rover 2014,8500000,1109199,3180252,2071053,-5319748,2014,"Action,Crime,Drama",David MichÃ´d,-86.9506,-75.6346705882353,-62.585270588235296
1133,2017-12-31,Posledniy bogatyr 2017,8500000,0,30700192,30700192,22200192,2017,"Action,Adventure,Comedy",Dmitriy Dyachenko,-100.0,261.1787294117647,261.1787294117647
1134,2013-05-31,Yeh Jawaani Hai Deewani 2013,8300000,3827466,50827466,47000000,42527466,2013,"Comedy,Drama,Musical",Ayan Mukherjee,-53.88595180722891,466.26506024096386,512.3791084337349
1136,2019-05-03,The Intruder 2019,8000000,35095904,36005871,909967,28005871,2019,"Drama,Horror,Mystery",Deon Taylor,338.6988,-88.6254125,350.07338749999997
1137,2011-09-30,50/50 2011,8000000,35016118,41334735,6318617,33334735,2011,"Comedy,Drama,Romance",Jonathan Levine,337.70147499999996,-21.017287500000002,416.6841875
1138,2015-09-02,A Walk in the Woods 2015,8000000,29499394,37119358,7619964,29119358,2015,"Adventure,Biography,Comedy",Ken Kwapis,268.74242499999997,-4.75045,363.99197499999997
1139,2014-01-31,That Awkward Moment 2014,8000000,26068955,53068955,27000000,45068955,2014,"Comedy,Romance",Tom Gormican,225.86193749999998,237.5,563.3619375000001
1140,2013-09-18,Enough Said 2013,8000000,17550872,25621449,8070577,17621449,2013,"Comedy,Drama,Romance",Nicole Holofcener,119.3859,0.8822125000000001,220.26811249999997
1141,2011-04-29,Prom 2011,8000000,10130219,10763183,632964,2763183,2011,"Comedy,Drama,Family",Joe Nussbaum,26.6277375,-92.08794999999999,34.5397875
1142,2015-06-12,Me and Earl and the Dying Girl 2015,8000000,6758416,9266180,2507764,1266180,2015,"Comedy,Drama,Romance",Alfonso Gomez-Rejon,-15.5198,-68.65295,15.827250000000001
1144,2016-09-02,Morgan 2016,8000000,3915251,7298786,3383535,-701214,2016,"Action,Horror,Sci-Fi",Luke Scott,-51.059362500000006,-57.7058125,-8.765175
1145,2015-12-30,Anomalisa 2015,8000000,3759286,5706168,1946882,-2293832,2015,"Animation,Comedy,Drama","Duke Johnson, Charlie Kaufman",-53.008925,-75.66397500000001,-28.672900000000002
1148,2018-10-26,London Fields 2018,8000000,252676,433732,181056,-7566268,2018,"Crime,Mystery,Thriller",Mathew Cullen,-96.84155,-97.7368,-94.57835
1149,2011-09-16,Restless 2011,8000000,163753,2772511,2608758,-5227489,2011,"Drama,Romance",Gus Van Sant,-97.95308750000001,-67.390525,-65.3436125
1151,2016-11-18,A Street Cat Named Bob 2016,8000000,82703,17382693,17299990,9382693,2016,"Biography,Comedy,Drama",Roger Spottiswoode,-98.9662125,116.24987499999999,117.28366249999999
1152,2014-08-12,Swelter 2014,8000000,0,44197,44197,-7955803,2014,"Action,Crime,Drama",Keith Parmer,-100.0,-99.44753750000001,-99.44753750000001
1153,2016-05-06,Code of Honor 2016,8000000,0,0,0,-8000000,2016,"Action,Crime,Thriller",Michael Winnick,-100.0,-100.0,-100.0
1154,2011-12-21,Albert Nobbs 2011,7500000,3014696,8539003,5524307,1039003,2011,"Drama,Romance",Rodrigo GarcÃ­a,-59.80405333333333,-26.342573333333334,13.853373333333332
1155,2016-06-24,The Neon Demon 2016,7500000,1333124,3559803,2226679,-3940197,2016,"Horror,Thriller",Nicolas Winding Refn,-82.22501333333334,-70.31094666666667,-52.53596
1156,2015-05-15,Pound of Flesh 2015,7500000,0,0,0,-7500000,2015,"Action,Thriller",Ernie Barbarash,-100.0,-100.0,-100.0
1157,2017-01-13,The Bye Bye Man 2017,7400000,22395806,31187727,8791921,23787727,2017,"Drama,Fantasy,Horror",Stacy Title,202.64602702702703,18.809743243243243,321.4557702702703
1158,2012-06-29,Magic Mike 2012,7000000,113721571,170549753,56828182,163549753,2012,"Comedy,Drama",Steven Soderbergh,1524.5938714285714,711.8311714285715,2336.4250428571427
1159,2018-03-16,I Can Only Imagine 2018,7000000,83482352,85604221,2121869,78604221,2018,"Biography,Drama,Family","Andrew Erwin, Jon Erwin",1092.6050285714286,-69.68758571428572,1122.917442857143
1160,2019-03-15,Five Feet Apart 2019,7000000,45729221,80504421,34775200,73504421,2019,"Drama,Romance",Justin Baldoni,553.2745857142858,396.78857142857146,1050.0631571428573
1161,2011-05-06,Jumping the Broom 2011,7000000,37295394,38158601,863207,31158601,2011,"Comedy,Drama",Salim Akil,432.79134285714287,-87.66847142857142,445.12287142857144
1162,2017-04-07,Gifted 2017,7000000,24801212,36964656,12163444,29964656,2017,Drama,Marc Webb,254.3030285714286,73.76348571428572,428.0665142857143
1163,2015-06-19,Dope 2015,7000000,17506470,18190831,684361,11190831,2015,"Comedy,Crime,Drama",Rick Famuyiwa,150.09242857142857,-90.22341428571428,159.8690142857143
1164,2014-01-17,Devil's Due 2014,7000000,15821461,36146087,20324626,29146087,2014,"Horror,Mystery,Thriller","Matt Bettinelli-Olpin, Tyler Gillett",126.02087142857144,190.3518,416.37267142857144
1165,2014-11-14,Beyond the Lights 2014,7000000,14618727,14618727,0,7618727,2014,"Drama,Music,Romance",Gina Prince-Bythewood,108.83895714285714,-100.0,108.83895714285714
1169,2013-11-15,The Christmas Candle 2013,7000000,1632000,1933829,301829,-5066171,2013,"Drama,Family",John Stephenson,-76.68571428571428,-95.68815714285715,-72.37387142857142
1170,2015-10-02,Freeheld 2015,7000000,546201,1732228,1186027,-5267772,2015,"Biography,Drama,Romance",Peter Sollett,-92.19712857142856,-83.05675714285714,-75.25388571428572
1173,2016-12-06,Oddball 2016,7000000,0,10237229,10237229,3237229,2016,Documentary,Joshua Moore,-100.0,46.24612857142857,46.24612857142857
1174,2015-11-20,Criminal Activities 2015,7000000,0,386744,386744,-6613256,2015,"Crime,Drama,Thriller",Jackie Earle Haley,-100.0,-94.47508571428571,-94.47508571428571
1175,2012-09-21,House at the End of the Street 2012,6900000,31611916,44103982,12492066,37203982,2012,"Drama,Horror,Thriller",Mark Tonderai,358.1437101449275,81.0444347826087,539.1881449275362
1177,2014-10-03,Annabelle 2014,6500000,84273813,256862920,172589107,250362920,2014,"Horror,Mystery,Thriller",John R. Leonetti,1196.5202,2555.217030769231,3851.7372307692303
1178,2017-10-20,Same Kind of Different as Me 2017,6500000,6423605,6423605,0,-76395,2017,"Biography,Drama",Michael Carney,-1.1753076923076924,-100.0,-1.1753076923076924
1179,2011-12-02,Shame 2011,6500000,4002293,20412841,16410548,13912841,2011,Drama,Steve McQueen,-38.42626153846154,152.46996923076924,214.04370769230766
1180,2013-05-31,The East 2013,6500000,2274649,3027956,753307,-3472044,2013,"Adventure,Drama,Thriller",Zal Batmanglij,-65.00540000000001,-88.41066153846154,-53.416061538461534
1181,2018-05-11,Breaking In 2018,6000000,46840590,51411620,4571030,45411620,2018,"Action,Crime,Drama",James McTeigue,680.6765,-23.816166666666668,756.8603333333333
1182,2019-03-29,Unplanned 2019,6000000,18107621,18107621,0,12107621,2019,"Biography,Drama","Chuck Konzelman, Cary Solomon",201.79368333333332,-100.0,201.79368333333332
1183,2019-02-08,The Prodigy 2019,6000000,14856291,19789712,4933421,13789712,2019,"Horror,Thriller",Nicholas McCarthy,147.60485,-17.776316666666666,229.82853333333333
1184,2018-11-30,The Possession of Hannah Grace 2018,6000000,14836174,42785387,27949213,36785387,2018,"Horror,Mystery,Thriller",Diederik Van Rooijen,147.26956666666666,365.8202166666667,613.0897833333333
1185,2012-09-07,The Words 2012,6000000,11494838,16369708,4874870,10369708,2012,"Drama,Mystery,Romance","Brian Klugman, Lee Sternthal",91.58063333333332,-18.752166666666668,172.82846666666666
1186,2012-03-16,Casa de mi Padre 2012,6000000,5909483,8446952,2537469,2446952,2012,"Comedy,Western",Matt Piedmont,-1.5086166666666667,-57.70885,40.78253333333333
1187,2011-07-29,The Guard 2011,6000000,5359774,21197454,15837680,15197454,2011,"Comedy,Crime,Thriller",John Michael McDonagh,-10.670433333333333,163.96133333333333,253.29090000000002
1188,2014-07-18,Wish I Was Here 2014,6000000,3591299,6591365,3000066,591365,2014,"Comedy,Drama",Zach Braff,-40.14501666666666,-49.9989,9.856083333333334
1189,2014-03-14,Veronica Mars 2014,6000000,3322127,3485383,163256,-2514617,2014,"Crime,Drama,Mystery",Rob Thomas,-44.63121666666667,-97.27906666666667,-41.91028333333333
1190,2011-07-15,Snow Flower and the Secret Fan 2011,6000000,1348205,11348205,10000000,5348205,2011,"Drama,History",Wayne Wang,-77.52991666666667,66.66666666666666,89.13674999999999
1191,2018-09-14,Mandy 2018,6000000,1214525,1427656,213131,-4572344,2018,"Action,Fantasy,Horror",Panos Cosmatos,-79.75791666666666,-96.44781666666667,-76.20573333333334
1192,2012-12-07,Deadfall 2012,6000000,66351,1673635,1607284,-4326365,2012,"Crime,Drama,Thriller",Stefan Ruzowitzky,-98.89415,-73.21193333333333,-72.10608333333333
1194,2011-05-10,The Hit List 2011,6000000,0,0,0,-6000000,2011,"Action,Thriller",William Kaufman,-100.0,-100.0,-100.0
1195,2012-10-05,Trade of Innocents 2012,5800000,15091,15091,0,-5784909,2012,"Drama,Thriller",Christopher M. Bessette,-99.73981034482759,-100.0,-99.73981034482759
1197,2012-12-07,Khiladi 786 2012,5600000,385422,14683763,14298341,9083763,2012,"Action,Comedy",Ashish R. Mohan,-93.11746428571429,155.32751785714285,162.21005357142857
1198,2013-09-27,Don Jon 2013,5500000,24477704,41268579,16790875,35768579,2013,"Comedy,Drama,Romance",Joseph Gordon-Levitt,345.04916363636363,205.28863636363636,650.3378
1199,2018-09-28,Hell Fest 2018,5500000,11107431,18119231,7011800,12619231,2018,Horror,Gregory Plotkin,101.95329090909091,27.487272727272728,229.44056363636363
1200,2011-10-21,Le Havre 2011,5500000,611709,13480196,12868487,7980196,2011,"Comedy,Drama",Aki KaurismÃ¤ki,-88.87801818181819,133.9724909090909,145.09447272727272
1201,2011-07-15,Salvation Boulevard 2011,5500000,28468,28468,0,-5471532,2011,"Action,Comedy,Drama",George Ratliff,-99.4824,-100.0,-99.4824
1202,2011-04-22,Dum Maaro Dum 2011,5200000,564489,11633427,11068938,6433427,2011,"Action,Crime,Drama",Rohan Sippy,-89.1444423076923,112.8641923076923,123.71974999999999
1203,2017-02-24,Get Out 2017,5000000,176040665,255367951,79327286,250367951,2017,"Horror,Mystery,Thriller",Jordan Peele,3420.8133,1486.54572,5007.35902
1204,2011-10-21,Paranormal Activity 3 2011,5000000,104028807,207039844,103011037,202039844,2011,"Horror,Mystery,Thriller","Henry Joost, Ariel Schulman",1980.5761400000001,1960.2207400000002,4040.79688
1205,2016-03-11,10 Cloverfield Lane 2016,5000000,72082999,108286422,36203423,103286422,2016,"Drama,Horror,Mystery",Dan Trachtenberg,1341.65998,624.06846,2065.7284400000003
1206,2016-07-22,Lights Out 2016,5000000,67268835,148806510,81537675,143806510,2016,"Drama,Horror,Mystery",David F. Sandberg,1245.3766999999998,1530.7535,2876.1302
1208,2015-09-11,The Visit 2015,5000000,65206105,98677816,33471711,93677816,2015,"Horror,Mystery,Thriller",M. Night Shyamalan,1204.1221,569.43422,1873.5563200000001
1209,2017-10-13,Happy Death Day 2017,5000000,55683845,125010260,69326415,120010260,2017,"Horror,Mystery,Thriller",Christopher Landon,1013.6768999999999,1286.5283,2400.2052
1210,2012-10-19,Paranormal Activity 4 2012,5000000,53900335,142817992,88917657,137817992,2012,"Horror,Mystery,Thriller","Henry Joost, Ariel Schulman",978.0067,1678.3531400000002,2756.35984
1211,2014-10-24,Ouija 2014,5000000,50856010,103300632,52444622,98300632,2014,"Horror,Mystery,Thriller",Stiles White,917.1202,948.89244,1966.01264
1212,2015-08-07,The Gift 2015,5000000,43787265,58978477,15191212,53978477,2015,"Drama,Mystery,Thriller",Joel Edgerton,775.7453,203.82424,1079.56954
1213,2017-06-23,The Big Sick 2017,5000000,42872467,53972860,11100393,48972860,2017,"Comedy,Drama,Romance",Michael Showalter,757.44934,122.00786,979.4572000000001
1214,2014-01-03,Paranormal Activity: The Marked Ones 2014,5000000,32462372,90904854,58442482,85904854,2014,"Horror,Mystery,Thriller",Christopher Landon,549.24744,1068.84964,1718.09708
1215,2013-11-01,Dallas Buyers Club 2013,5000000,27298285,60611845,33313560,55611845,2013,"Biography,Drama",Jean-Marc VallÃ©e,445.96569999999997,566.2712,1112.2369
1216,2015-08-26,No Escape 2015,5000000,27288872,42844516,15555644,37844516,2015,"Action,Thriller",John Erick Dowdle,445.77744,211.11288,756.89032
1217,2015-02-27,The Lazarus Effect 2015,5000000,25801570,38359310,12557740,33359310,2015,"Horror,Mystery,Sci-Fi",David Gelb,416.03139999999996,151.1548,667.1862
1218,2011-08-26,Our Idiot Brother 2011,5000000,24814830,25861249,1046419,20861249,2011,"Comedy,Drama",Jesse Peretz,396.2966,-79.07162,417.22498
1219,2018-03-09,The Strangers: Prey at Night 2018,5000000,24431472,29960051,5528579,24960051,2018,Horror,Johannes Roberts,388.62944,10.571579999999999,499.20102
1220,2013-07-05,The Way Way Back 2013,5000000,21502690,26853810,5351120,21853810,2013,"Comedy,Drama","Nat Faxon, Jim Rash",330.0538,7.022399999999999,437.07620000000003
1221,2014-08-29,"As Above, So Below 2014",5000000,21222315,41824066,20601751,36824066,2014,"Adventure,Horror,Mystery",John Erick Dowdle,324.4463,312.03502,736.4813200000001
1222,2016-02-19,Race 2016,5000000,19115191,23745772,4630581,18745772,2016,"Biography,Drama,Sport",Stephen Hopkins,282.30382000000003,-7.38838,374.91544
1223,2011-09-02,Apollo 18 2011,5000000,17686929,26517819,8830890,21517819,2011,"Horror,Mystery,Sci-Fi",Gonzalo LÃ³pez-Gallego,253.73858,76.6178,430.35638
1224,2018-03-23,"Paul, Apostle of Christ 2018",5000000,17547999,25529498,7981499,20529498,2018,"Adventure,Biography,Drama",Andrew Hyatt,250.95998000000003,59.62998,410.58995999999996
1225,2014-10-10,Addicted 2014,5000000,17390770,17499242,108472,12499242,2014,"Drama,Thriller",Bille Woodruff,247.8154,-97.83056,249.98484
1227,2017-06-09,It Comes at Night 2017,5000000,13985117,19720203,5735086,14720203,2017,"Horror,Mystery",Trey Edward Shults,179.70234,14.701719999999998,294.40406
1228,2017-03-03,Before I Fall 2017,5000000,12241072,18945682,6704610,13945682,2017,"Drama,Fantasy,Mystery",Ry Russo-Young,144.82144,34.0922,278.91364
1229,2016-01-29,Fifty Shades of Black 2016,5000000,11686940,22113075,10426135,17113075,2016,Comedy,Michael Tiddes,133.7388,108.5227,342.2615
1230,2016-03-11,The Perfect Match 2016,5000000,9669521,10182050,512529,5182050,2016,"Comedy,Romance",Bille Woodruff,93.39041999999999,-89.74942,103.641
1231,2018-09-21,Fahrenheit 11/9 2018,5000000,6352306,6653715,301409,1653715,2018,Documentary,Michael Moore,27.046120000000002,-93.97182,33.0743
1233,2015-09-11,90 Minutes in Heaven 2015,5000000,4816142,4816142,0,-183858,2015,Drama,Michael Polish,-3.67716,-100.0,-3.67716
1234,2016-12-02,Incarnate 2016,5000000,4799774,9371036,4571262,4371036,2016,"Horror,Thriller",Brad Peyton,-4.00452,-8.57476,87.42072
1235,2017-03-03,Table 19 2017,5000000,3614896,4620399,1005503,-379601,2017,"Comedy,Drama,Romance",Jeffrey Blitz,-27.702080000000002,-79.88994000000001,-7.59202
1236,2016-03-04,The Other Side of the Door 2016,5000000,3000342,12905107,9904765,7905107,2016,Horror,Johannes Roberts,-39.99316,98.0953,158.10214
1237,2014-10-10,Kill the Messenger 2014,5000000,2450846,6656705,4205859,1656705,2014,"Biography,Crime,Drama",Michael Cuesta,-50.98308,-15.88282,33.1341
1239,2015-10-23,Jem and the Holograms 2015,5000000,2184640,2368937,184297,-2631063,2015,"Adventure,Drama,Family",Jon M. Chu,-56.3072,-96.31406,-52.62126000000001
1240,2016-12-28,Paterson 2016,5000000,2141423,10727536,8586113,5727536,2016,"Comedy,Drama,Romance",Jim Jarmusch,-57.17154,71.72226,114.55072
1241,2014-09-12,Atlas Shrugged: Who Is John Galt? 2014,5000000,851690,851690,0,-4148310,2014,"Drama,Mystery,Sci-Fi",James Manera,-82.9662,-100.0,-82.9662
1242,2013-08-16,Ain't Them Bodies Saints 2013,5000000,391611,1075009,683398,-3924991,2013,"Crime,Drama,Romance",David Lowery,-92.16778,-86.33203999999999,-78.49982
1243,2015-08-07,Cop Car 2015,5000000,134552,143658,9106,-4856342,2015,"Crime,Thriller",Jon Watts,-97.30896,-99.81788,-97.12684
1244,2014-10-17,Rudderless 2014,5000000,56001,567219,511218,-4432781,2014,"Comedy,Drama,Music",William H. Macy,-98.87998,-89.77564,-88.65562
1245,2015-05-15,Area 51 2015,5000000,7556,7556,0,-4992444,2015,"Horror,Sci-Fi,Thriller",Oren Peli,-99.84888,-100.0,-99.84888
1246,2014-12-05,Dying of the Light 2014,5000000,0,74639,74639,-4925361,2014,"Drama,Thriller",Paul Schrader,-100.0,-98.50721999999999,-98.50721999999999
1247,2016-09-02,Yoga Hosers 2016,5000000,0,22958,22958,-4977042,2016,"Action,Comedy,Fantasy",Kevin Smith,-100.0,-99.54084,-99.54084
1248,2014-11-21,Reach Me 2014,5000000,0,0,0,-5000000,2014,"Comedy,Crime,Drama",John Herzfeld,-100.0,-100.0,-100.0
1249,2014-08-18,Henry & Me 2014,5000000,0,0,0,-5000000,2014,"Animation,Family",Barrett Esposito,-100.0,-100.0,-100.0
1250,2012-12-31,Should've Been Romeo 2012,5000000,0,0,0,-5000000,2012,"Comedy,Drama",Marc Bennett,-100.0,-100.0,-100.0
1251,2015-10-27,Running Forever 2015,5000000,0,0,0,-5000000,2015,Family,"Dan Garcia, Mike Mayhall",-100.0,-100.0,-100.0
1252,2013-07-19,Only God Forgives 2013,4800000,775849,4494560,3718711,-305440,2013,"Crime,Drama",Nicolas Winding Refn,-83.83647916666666,-22.526854166666666,-6.363333333333333
1253,2011-09-30,Take Shelter 2011,4750000,1728953,4972016,3243063,222016,2011,"Drama,Horror,Thriller",Jeff Nichols,-63.60098947368421,-31.72498947368421,4.674021052631579
1254,2011-12-31,Without Men 2011,4700000,0,0,0,-4700000,2011,Comedy,Gabriela Tagliavini,-100.0,-100.0,-100.0
1255,2011-10-07,Blackthorn 2011,4500000,200558,1217307,1016749,-3282693,2011,"Action,Adventure,Western",Mateo Gil,-95.54315555555556,-77.40557777777778,-72.94873333333334
1256,2015-05-08,Maggie 2015,4500000,187112,1027760,840648,-3472240,2015,"Drama,Horror",Henry Hobson,-95.84195555555556,-81.31893333333333,-77.16088888888889
1257,2014-09-04,Falcon Rising 2014,4500000,11774,11774,0,-4488226,2014,"Action,Adventure",Ernie Barbarash,-99.73835555555556,-100.0,-99.73835555555556
1258,2013-06-25,Hansel & Gretel Get Baked 2013,4500000,0,0,0,-4500000,2013,"Comedy,Horror",Duane Journey,-100.0,-100.0,-100.0
1259,2014-11-07,Fugly 2014,4500000,0,0,0,-4500000,2014,"Drama,Thriller",Kabir Sadanand,-100.0,-100.0,-100.0
1260,2015-08-28,Zipper 2015,4500000,0,0,0,-4500000,2015,"Drama,Thriller",Mora Stephens,-100.0,-100.0,-100.0
1261,2015-11-03,The Final Girls 2015,4500000,0,0,0,-4500000,2015,"Comedy,Drama,Fantasy",Todd Strauss-Schulson,-100.0,-100.0,-100.0
1262,2017-12-01,Daisy Winters 2017,4500000,0,0,0,-4500000,2017,Drama,Beth LaMure,-100.0,-100.0,-100.0
1264,2011-10-21,Cargo 2011,4200000,0,313230,313230,-3886770,2011,Drama,Yan Vizinberg,-100.0,-92.54214285714286,-92.54214285714286
1265,2015-01-23,The Boy Next Door 2015,4000000,36006065,53401938,17395873,49401938,2015,"Horror,Thriller",Rob Cohen,800.151625,334.896825,1235.04845
1266,2014-07-11,Boyhood 2014,4000000,25379975,57273049,31893074,53273049,2014,Drama,Richard Linklater,534.4993750000001,697.3268499999999,1331.826225
1268,2014-04-18,A Haunted House 2 2014,4000000,17329487,21206861,3877374,17206861,2014,"Comedy,Fantasy",Michael Tiddes,333.237175,-3.0656499999999998,430.171525
1269,2013-03-01,The Last Exorcism Part II 2013,4000000,15179303,25448707,10269404,21448707,2013,"Drama,Horror,Thriller",Ed Gass-Donnelly,279.482575,156.7351,536.217675
1270,2016-05-13,The Darkness 2016,4000000,10753574,10898293,144719,6898293,2016,"Horror,Thriller",Greg McLean,168.83935000000002,-96.382025,172.457325
1272,2011-06-17,The Art of Getting By 2011,4000000,1430241,1989035,558794,-2010965,2011,"Drama,Romance",Gavin Wiesen,-64.24397499999999,-86.03015,-50.274125000000005
1273,2011-09-23,Red State 2011,4000000,1065429,1983596,918167,-2016404,2011,"Action,Crime,Horror",Kevin Smith,-73.364275,-77.04582500000001,-50.4101
1274,2012-10-17,Holy Motors 2012,4000000,641054,4230426,3589372,230426,2012,"Drama,Fantasy",Leos Carax,-83.97365,-10.265699999999999,5.76065
1275,2014-06-13,The Signal 2014,4000000,600896,2665322,2064426,-1334678,2014,"Drama,Mystery,Sci-Fi",William Eubank,-84.9776,-48.38935,-33.36695
1276,2014-04-11,Joe 2014,4000000,373375,373375,0,-3626625,2014,Documentary,Alfonso Perugini,-90.665625,-100.0,-90.665625
1278,2019-06-07,Late Night 2019,4000000,246305,246305,0,-3753695,2019,"Comedy,Drama",Nisha Ganatra,-93.842375,-100.0,-93.842375
1279,2014-04-18,13 Sins 2014,4000000,9134,47552,38418,-3952448,2014,"Horror,Thriller",Daniel Stamm,-99.77165,-99.03954999999999,-98.8112
1280,2011-11-18,Another Happy Day 2011,4000000,9120,978527,969407,-3021473,2011,"Comedy,Drama",Sam Levinson,-99.772,-75.764825,-75.536825
1281,2014-07-11,The Perfect Wave 2014,4000000,0,0,0,-4000000,2014,"Adventure,Biography,Drama",Bruce Macdonald,-100.0,-100.0,-100.0
1282,2015-09-08,Chain of Command 2015,4000000,0,0,0,-4000000,2015,"Action,Thriller",Kevin Carraway,-100.0,-100.0,-100.0
1284,2018-04-13,Truth or Dare 2018,3500000,41411015,95127344,53716329,91627344,2018,"Horror,Thriller",Jeff Wadlow,1083.171857142857,1434.7522571428572,2617.9241142857145
1286,2018-02-02,Winchester 2018,3500000,25091816,44378040,19286224,40878040,2018,"Biography,Drama,Fantasy","Peter Spierig, Michael Spierig",616.9090285714286,451.0349714285714,1167.944
1287,2013-02-22,Dark Skies 2013,3500000,17418667,27704111,10285444,24204111,2013,"Horror,Sci-Fi,Thriller",Scott Stewart,397.6762,193.86982857142857,691.5460285714286
1288,2018-01-19,Forever My Girl 2018,3500000,16376066,16376066,0,12876066,2018,"Drama,Music,Romance",Bethany Ashton Wolf,367.88759999999996,-100.0,367.88759999999996
1289,2016-12-02,Believe 2016,3500000,890303,890303,0,-2609697,2016,Drama,Billy Dickson,-74.56277142857142,-100.0,-74.56277142857142
1290,2016-09-30,American Honey 2016,3500000,663247,2611750,1948503,-888250,2016,"Adventure,Drama,Romance",Andrea Arnold,-81.05008571428571,-44.32848571428571,-25.378571428571426
1291,2016-01-08,The Masked Saint 2016,3500000,182695,182695,0,-3317305,2016,"Action,Biography,Crime",Warren P. Sonoda,-94.78014285714286,-100.0,-94.78014285714286
1292,2011-12-31,The Kick 2011,3500000,0,40622,40622,-3459378,2011,"Action,Sport",Prachya Pinkaew,-100.0,-98.83937142857143,-98.83937142857143
1293,2011-10-21,Margin Call 2011,3400000,5353586,20433227,15079641,17033227,2011,"Drama,Thriller",J.C. Chandor,57.458411764705886,343.5188529411765,500.9772647058823
1294,2014-10-10,Whiplash 2014,3300000,13092006,38969037,25877031,35669037,2014,"Drama,Music",Damien Chazelle,296.7274545454545,684.1524545454545,1080.879909090909
1295,2018-07-06,Sorry to Bother You 2018,3200000,17493096,18285560,792464,15085560,2018,"Comedy,Fantasy,Sci-Fi",Boots Riley,446.65925,-75.2355,471.42375000000004
1297,2015-08-28,War Room 2015,3000000,67790117,73975239,6185122,70975239,2015,Drama,Alex Kendrick,2159.6705666666667,106.17073333333333,2365.8413
1298,2013-06-07,The Purge 2013,3000000,64473115,91266581,26793466,88266581,2013,"Horror,Thriller",James DeMonaco,2049.103833333333,793.1155333333332,2942.2193666666667
1299,2012-10-12,Sinister 2012,3000000,48086903,87727807,39640904,84727807,2012,"Horror,Mystery,Thriller",Scott Derrickson,1502.8967666666667,1221.3634666666667,2824.2602333333334
1300,2018-06-01,Upgrade 2018,3000000,11977130,16553285,4576155,13553285,2018,"Action,Sci-Fi,Thriller",Leigh Whannell,299.23766666666666,52.5385,451.7761666666667
1301,2013-05-24,Before Midnight 2013,3000000,8110621,23251930,15141309,20251930,2013,"Drama,Romance",Richard Linklater,170.35403333333335,404.71029999999996,675.0643333333334
1302,2017-10-27,Let There Be Light 2017,3000000,7233471,7241309,7838,4241309,2017,Drama,Kevin Sorbo,141.1157,-99.73873333333333,141.37696666666665
1304,2016-06-24,Swiss Army Man 2016,3000000,4210454,5837111,1626657,2837111,2016,"Adventure,Comedy,Drama","Dan Kwan, Daniel Scheinert",40.34846666666667,-45.7781,94.57036666666667
1306,2016-04-22,Compadres 2016,3000000,3127773,7445044,4317271,4445044,2016,"Action,Comedy,Crime",Enrique BegnÃ©,4.2591,43.90903333333333,148.16813333333334
1308,2014-09-19,Tusk 2014,3000000,1821983,1887554,65571,-1112446,2014,"Comedy,Drama,Horror",Kevin Smith,-39.26723333333334,-97.8143,-37.08153333333333
1309,2017-05-12,The Wall 2017,3000000,1803064,4495262,2692198,1495262,2017,"Action,Drama,Thriller",Doug Liman,-39.897866666666665,-10.260066666666667,49.84206666666667
1312,2011-05-06,Hobo with a Shotgun 2011,3000000,703372,834953,131581,-2165047,2011,"Action,Comedy,Horror",Jason Eisener,-76.55426666666668,-95.61396666666667,-72.16823333333333
1313,2015-05-08,The D Train 2015,3000000,669688,772366,102678,-2227634,2015,"Comedy,Drama","Andrew Mogel, Jarrad Paul",-77.67706666666668,-96.5774,-74.25446666666666
1314,2012-09-07,Bachelorette 2012,3000000,446770,12577401,12130631,9577401,2012,"Comedy,Romance",Leslye Headland,-85.10766666666667,304.3543666666667,319.24670000000003
1315,2011-09-09,Creature 2011,3000000,331000,331000,0,-2669000,2011,Horror,Fred Andrews,-88.96666666666667,-100.0,-88.96666666666667
1316,2016-12-09,The Bounce Back 2016,3000000,321910,421404,99494,-2578596,2016,"Comedy,Romance",Youssef Delara,-89.26966666666667,-96.68353333333334,-85.9532
1317,2012-03-02,Tim and Eric's Billion Dollar Movie 2012,3000000,201436,223652,22216,-2776348,2012,Comedy,"Eric Wareheim, Tim Heidecker",-93.28546666666668,-99.25946666666667,-92.54493333333333
1318,2014-06-27,They Came Together 2014,3000000,0,82780,82780,-2917220,2014,"Comedy,Romance",David Wain,-100.0,-97.24066666666667,-97.24066666666667
1319,2013-05-21,Open Road 2013,3000000,0,47469,47469,-2952531,2013,"Action,Drama,Thriller",Marcio Garcia,-100.0,-98.4177,-98.4177
1321,2015-12-31,AWOL-72 2015,3000000,0,0,0,-3000000,2015,"Action,Thriller",Christian Sesma,-100.0,-100.0,-100.0
1322,2015-12-31,Unnatural 2015,3000000,0,0,0,-3000000,2015,"Action,Horror,Sci-Fi",Hank Braxtan,-100.0,-100.0,-100.0
1323,2015-12-11,Close Range 2015,3000000,0,0,0,-3000000,2015,"Action,Crime",Isaac Florentine,-100.0,-100.0,-100.0
1325,2018-10-26,Indivisible 2018,2700000,3511417,3588305,76888,888305,2018,"Drama,War",David G. Evans,30.05248148148148,-97.1522962962963,32.90018518518519
1326,2015-12-31,Sardaar Ji 2015,2700000,0,8200000,8200000,5500000,2015,"Comedy,Fantasy,Horror",Rohit Jugraj,-100.0,203.70370370370372,203.70370370370372
1327,2013-01-11,A Haunted House 2013,2500000,40041683,59922558,19880875,57422558,2013,"Comedy,Fantasy",Michael Tiddes,1501.66732,695.235,2296.9023199999997
1328,2013-07-03,Kevin Hart: Let Me Explain 2013,2500000,32244051,32327255,83204,29827255,2013,"Comedy,Documentary","Tim Story, Leslie Small",1189.7620399999998,-96.67184,1193.0901999999999
1329,2013-08-02,The Spectacular Now 2013,2500000,6852971,6916951,63980,4416951,2013,"Comedy,Drama,Romance",James Ponsoldt,174.11884,-97.44080000000001,176.67804
1330,2016-06-24,Hunt for the Wilderpeople 2016,2500000,5205471,23845533,18640062,21345533,2016,"Adventure,Comedy,Drama",Taika Waititi,108.21884,645.60248,853.8213199999999
1331,2012-08-17,Robot & Frank 2012,2500000,3317468,4934356,1616888,2434356,2012,"Comedy,Crime,Drama",Jake Schreier,32.698719999999994,-35.32448,97.37424
1332,2013-03-01,The Lost Medallion: The Adventures of Billy Stone 2013,2500000,549632,549632,0,-1950368,2013,"Adventure,Family,Fantasy",Bill Muir,-78.01472000000001,-100.0,-78.01472000000001
1334,2013-08-16,Underdogs 2013,2500000,35017,1392649,1357632,-1107351,2013,"Adventure,Animation,Family",Juan JosÃ© Campanella,-98.59932,-45.69472,-44.29404
1337,2015-07-03,Stung 2015,2500000,0,0,0,-2500000,2015,"Action,Adventure,Comedy",Benni Diez,-100.0,-100.0,-100.0
1338,2016-09-02,Antibirth 2016,2500000,0,0,0,-2500000,2016,Horror,Danny Perez,-100.0,-100.0,-100.0
1339,2014-11-14,Always Woodstock 2014,2400000,0,0,0,-2400000,2014,"Comedy,Music,Romance",Rita Merson,-100.0,-100.0,-100.0
1340,2015-03-20,Do You Believe? 2015,2300000,12985600,14304931,1319331,12004931,2015,Drama,Jon Gunn,464.5913043478261,-42.63778260869565,521.9535217391305
1341,2014-09-05,Frontera 2014,2300000,59696,59696,0,-2240304,2014,"Drama,Thriller,Western",Michael Berry,-97.40452173913043,-100.0,-97.40452173913043
1342,2016-01-19,Eden 2016,2300000,0,0,0,-2300000,2016,Drama,Robbie Walsh,-100.0,-100.0,-100.0
1343,2015-10-06,The Timber 2015,2100000,0,0,0,-2100000,2015,"Action,Adventure,Drama",Anthony O'Brien,-100.0,-100.0,-100.0
1344,2011-09-30,Courageous 2011,2000000,34522221,35185884,663663,33185884,2011,Drama,Alex Kendrick,1626.11105,-66.81685,1659.2942
1345,2018-07-13,Eighth Grade 2018,2000000,13539710,14341016,801306,12341016,2018,"Comedy,Drama",Bo Burnham,576.9855,-59.9347,617.0508
1347,2014-10-10,Meet the Mormons 2014,2000000,6047363,6049171,1808,4049171,2014,Documentary,Blair Treu,202.36814999999999,-99.9096,202.45855
1348,2017-10-06,The Florida Project 2017,2000000,5904366,11295324,5390958,9295324,2017,Drama,Sean Baker,195.2183,169.5479,464.7662
1349,2017-08-25,All Saints 2017,2000000,5802208,5941994,139786,3941994,2017,Drama,Steve Gomer,190.1104,-93.0107,197.0997
1351,2015-08-28,We Are Your Friends 2015,2000000,3591417,10153415,6561998,8153415,2015,"Drama,Music,Romance",Max Joseph,79.57085000000001,228.0999,407.67075000000006
1352,2015-09-18,Captive 2015,2000000,2583301,2791973,208672,791973,2015,"Action,Crime,Drama",Jerry Jameson,29.165049999999997,-89.5664,39.59865
1353,2018-06-08,Hearts Beat Loud 2018,2000000,2386254,2420962,34708,420962,2018,"Comedy,Drama,Music",Brett Haley,19.3127,-98.2646,21.0481
1354,2015-08-07,The Diary of a Teenage Girl 2015,2000000,1477002,2279959,802957,279959,2015,"Comedy,Drama,Romance",Marielle Heller,-26.1499,-59.85215,13.997950000000001
1355,2014-11-28,The Babadook 2014,2000000,950792,7482387,6531595,5482387,2014,"Drama,Horror",Jennifer Kent,-52.46039999999999,226.57975000000002,274.11935
1357,2014-09-19,Pump 2014,2000000,72277,72277,0,-1927723,2014,Documentary,"Rebecca Harrell Tickell, Joshua Tickell",-96.38615,-100.0,-96.38615
1358,2015-10-09,Knock Knock 2015,2000000,36336,6328516,6292180,4328516,2015,"Drama,Thriller",Eli Roth,-98.1832,214.609,216.42579999999998
1359,2012-10-19,The First Time 2012,2000000,17061,17061,0,-1982939,2012,"Comedy,Drama,Romance",Jonathan Kasdan,-99.14695,-100.0,-99.14695
1361,2013-09-13,Plush 2013,2000000,3080,28864,25784,-1971136,2013,"Drama,Music,Thriller",Catherine Hardwicke,-99.846,-98.71079999999999,-98.5568
1362,2012-10-26,The Ghastly Love of Johnny X 2012,2000000,2436,2436,0,-1997564,2012,"Comedy,Fantasy,Musical",Paul Bunnell,-99.87819999999999,-100.0,-99.87819999999999
1363,2011-09-09,Grave Encounters 2011,2000000,0,2151887,2151887,151887,2011,Horror,"Colin Minihan, Stuart Ortiz, The Vicious Brothers",-100.0,7.5943499999999995,7.5943499999999995
1364,2015-10-23,Bone Tomahawk 2015,2000000,0,475846,475846,-1524154,2015,"Adventure,Drama,Horror",S. Craig Zahler,-100.0,-76.2077,-76.2077
1365,2013-03-19,Straight A's 2013,2000000,0,0,0,-2000000,2013,"Comedy,Drama",James Cox,-100.0,-100.0,-100.0
1366,2012-12-31,Highway 2012,2000000,0,0,0,-2000000,2012,Comedy,Coke Daniels,-100.0,-100.0,-100.0
1368,2013-07-09,Coffee Town 2013,2000000,0,0,0,-2000000,2013,Comedy,Brad Copeland,-100.0,-100.0,-100.0
1369,2014-12-31,Lucky Dog 2014,2000000,0,0,0,-2000000,2014,Family,Michael Feifer,-100.0,-100.0,-100.0
1370,2015-03-20,The Walking Deceased 2015,2000000,0,0,0,-2000000,2015,"Comedy,Horror",Scott Dow,-100.0,-100.0,-100.0
1371,2011-12-31,True Bromance 2011,2000000,0,0,0,-2000000,2011,Comedy,Sebastian Doggart,-100.0,-100.0,-100.0
1372,2015-08-21,The Curse of Downers Grove 2015,2000000,0,0,0,-2000000,2015,"Drama,Horror,Mystery",Derick Martini,-100.0,-100.0,-100.0
1373,2015-12-31,Wind Walkers 2015,2000000,0,0,0,-2000000,2015,"Action,Horror,Thriller",Russell Friedenberg,-100.0,-100.0,-100.0
1374,2016-07-08,The Dog Lover 2016,2000000,0,0,0,-2000000,2016,Drama,Alex Ranarivelo,-100.0,-100.0,-100.0
1375,2015-12-01,Shark Lake 2015,2000000,0,0,0,-2000000,2015,"Action,Adventure,Crime",Jerry Dugan,-100.0,-100.0,-100.0
1377,2015-04-24,Brotherly Love 2015,1900000,478595,478595,0,-1421405,2015,Drama,Jamal Hill,-74.81078947368421,-100.0,-74.81078947368421
1379,2013-02-08,ABCD (Any Body Can Dance) 2013,1900000,222098,10137234,9915136,8237234,2013,"Drama,Music",Remo D'Souza,-88.31063157894738,421.84926315789477,433.53863157894733
1380,2013-07-26,Stranded 2013,1900000,0,285593,285593,-1614407,2013,"Horror,Sci-Fi",Roger Christian,-100.0,-84.96878947368421,-84.96878947368421
1381,2015-12-31,Vaalu 2015,1900000,0,12444,12444,-1887556,2015,"Comedy,Romance",Vijay Chandar,-100.0,-99.34505263157895,-99.34505263157895
1383,2012-06-27,Beasts of the Southern Wild 2012,1800000,12795746,23265132,10469386,21465132,2012,"Adventure,Drama,Fantasy",Benh Zeitlin,610.8747777777777,481.63255555555554,1192.5073333333335
1384,2011-08-23,Higher Ground 2011,1800000,841056,842693,1637,-957307,2011,Drama,Vera Farmiga,-53.27466666666667,-99.90905555555555,-53.183722222222215
1385,2012-02-03,Dysfunctional Friends 2012,1800000,0,0,0,-1800000,2012,"Comedy,Drama",Corey Grant,-100.0,-100.0,-100.0
1386,2013-12-31,Independence Daysaster 2013,1800000,0,0,0,-1800000,2013,"Action,Adventure,Sci-Fi",W.D. Hogan,-100.0,-100.0,-100.0
1388,2013-10-04,Grace Unplugged 2013,1700000,2507159,2507159,0,807159,2013,"Drama,Music",Brad J. Silverman,47.47994117647059,-100.0,47.47994117647059
1390,2014-09-26,Two Night Stand 2014,1600000,15600,868081,852481,-731919,2014,"Comedy,Romance",Max Nichols,-99.02499999999999,-46.7199375,-45.7449375
1391,2016-10-21,Moonlight 2016,1500000,27854931,65245512,37390581,63745512,2016,Drama,Barry Jenkins,1756.9954,2392.7054,4249.7008000000005
1392,2018-03-23,Unsane 2018,1500000,7690044,14244931,6554887,12744931,2018,"Drama,Horror,Mystery",Steven Soderbergh,412.6696,336.99246666666664,849.6620666666666
1393,2013-07-26,The To Do List 2013,1500000,3491669,4128828,637159,2628828,2013,"Comedy,Romance",Maggie Carey,132.77793333333335,-57.522733333333335,175.2552
1394,2016-10-21,31 2016,1500000,779820,922727,142907,-577273,2016,"Horror,Thriller",Rob Zombie,-48.012,-90.47286666666666,-38.48486666666667
1395,2013-10-25,The Square 2013,1500000,124244,176262,52018,-1323738,2013,"Documentary,Drama,History",Jehane Noujaim,-91.71706666666667,-96.53213333333333,-88.2492
1397,2015-03-06,Road Hard 2015,1500000,113169,113169,0,-1386831,2015,Comedy,"Adam Carolla, Kevin Hench",-92.4554,-100.0,-92.4554
1398,2014-10-17,Housebound 2014,1500000,0,236863,236863,-1263137,2014,"Comedy,Horror,Mystery",Gerard Johnstone,-100.0,-84.20913333333333,-84.20913333333333
1399,2018-07-20,Teefa in Trouble 2018,1500000,0,98806,98806,-1401194,2018,"Action,Comedy,Crime",Ahsan Rahim,-100.0,-93.41293333333334,-93.41293333333334
1400,2014-04-17,Closer to the Moon 2014,1500000,0,5396,5396,-1494604,2014,"Comedy,Crime,Drama",Nae Caranfil,-100.0,-99.64026666666666,-99.64026666666666
1401,2011-06-03,The Lion of Judah 2011,1500000,0,0,0,-1500000,2011,Animation,"Deryck Broom, Roger Hawkins",-100.0,-100.0,-100.0
1402,2015-11-20,#Horror 2015,1500000,0,0,0,-1500000,2015,"Crime,Drama,Horror",Tara Subkoff,-100.0,-100.0,-100.0
1403,2015-09-08,Checkmate 2015,1500000,0,0,0,-1500000,2015,"Action,Crime,Thriller",Timothy Woodward Jr.,-100.0,-100.0,-100.0
1404,2015-11-20,Mustang 2015,1400000,845464,5552584,4707120,4152584,2015,Drama,Deniz Gamze ErgÃ¼ven,-39.60971428571429,236.22285714285715,296.61314285714286
1406,2014-12-31,House at the End of the Drive 2014,1400000,0,0,0,-1400000,2014,"Horror,Thriller",David Worth,-100.0,-100.0,-100.0
1407,2014-10-17,Dear White People 2014,1250000,4404154,5403771,999617,4153771,2014,"Comedy,Drama,Romance",Justin Simien,252.33232,-20.03064,332.30168
1408,2013-04-19,Home Run 2013,1200000,2859955,2859955,0,1659955,2013,"Drama,Sport",David Boyd,138.32958333333335,-100.0,138.32958333333335
1409,2012-04-13,Blue Like Jazz 2012,1200000,595018,595018,0,-604982,2012,"Comedy,Drama",Steve Taylor,-50.415166666666664,-100.0,-50.415166666666664
1410,2012-09-07,Crowsnest 2012,1200000,0,0,0,-1200000,2012,"Horror,Mystery,Thriller",Brenton Spencer,-100.0,-100.0,-100.0
1411,2012-09-14,Airborne 2012,1200000,0,0,0,-1200000,2012,"Comedy,Crime,Horror",Dominic Burns,-100.0,-100.0,-100.0
1412,2015-02-03,Bleeding Hearts 2015,1200000,0,0,0,-1200000,2015,Horror,Dylan Bank,-100.0,-100.0,-100.0
1413,2014-11-21,The Sleepwalker 2014,1100000,2636,2636,0,-1097364,2014,Drama,Mona Fastvold,-99.76036363636364,-100.0,-99.76036363636364
1415,2013-12-31,The Vatican Exorcisms 2013,1100000,0,0,0,-1100000,2013,Horror,Joe Marino,-100.0,-100.0,-100.0
1416,2012-01-06,The Devil Inside 2012,1000000,53262945,101759490,48496545,100759490,2012,Horror,William Brent Bell,5226.2945,4749.6545,10075.949
1417,2012-05-25,Chernobyl Diaries 2012,1000000,18119640,42411721,24292081,41411721,2012,"Horror,Mystery,Thriller",Bradley Parker,1711.964,2329.2081,4141.1721
1419,2018-07-20,Unfriended: Dark Web 2018,1000000,8866745,16434588,7567843,15434588,2018,"Crime,Horror,Mystery",Stephen Susco,786.6745,656.7843,1543.4587999999999
1420,2012-10-19,The Sessions 2012,1000000,6002451,11495204,5492753,10495204,2012,"Biography,Comedy,Drama",Ben Lewin,500.2451,449.2753,1049.5203999999999
1421,2014-09-12,The Skeleton Twins 2014,1000000,5284309,5797192,512883,4797192,2014,"Comedy,Drama,Romance",Craig Johnson,428.43090000000007,-48.7117,479.7192
1422,2014-06-06,Obvious Child 2014,1000000,3122616,3324070,201454,2324070,2014,"Comedy,Drama,Romance",Gillian Robespierre,212.2616,-79.8546,232.40699999999998
1423,2011-10-21,Martha Marcy May Marlene 2011,1000000,2981038,5438911,2457873,4438911,2011,"Drama,Mystery,Thriller",Sean Durkin,198.1038,145.7873,443.8911
1424,2017-08-18,Patti Cake$ 2017,1000000,800148,1471090,670942,471090,2017,"Drama,Music",Geremy Jasper,-19.9852,-32.9058,47.109
1425,2011-07-29,The Future 2011,1000000,568662,1239174,670512,239174,2011,"Drama,Fantasy,Romance",Miranda July,-43.1338,-32.9488,23.9174
1426,2014-10-24,23 Blast 2014,1000000,549185,549185,0,-450815,2014,"Drama,Family,Sport",Dylan Baker,-45.081500000000005,-100.0,-45.081500000000005
1427,2014-07-18,I Origins 2014,1000000,336472,852399,515927,-147601,2014,"Drama,Romance,Sci-Fi",Mike Cahill,-66.3528,-48.4073,-14.760100000000001
1428,2012-06-01,Hardflip 2012,1000000,96734,96734,0,-903266,2012,"Action,Drama",Johnny Remo,-90.3266,-100.0,-90.3266
1429,2014-10-17,Camp X-Ray 2014,1000000,9837,101053,91216,-898947,2014,"Drama,War",Peter Sattler,-99.0163,-90.8784,-89.8947
1430,2013-12-31,Heli 2013,1000000,0,552614,552614,-447386,2013,"Crime,Drama,Romance",Amat Escalante,-100.0,-44.7386,-44.7386
1431,2015-12-31,Karachi se Lahore 2015,1000000,0,17721,17721,-982279,2015,"Adventure,Comedy,Family",Wajahat Rauf,-100.0,-98.2279,-98.2279
1432,2015-12-11,American Hero 2015,1000000,0,26,26,-999974,2015,"Action,Comedy,Drama",Nick Love,-100.0,-99.9974,-99.9974
1433,2012-03-20,Snow White: A Deadly Summer 2012,1000000,0,0,0,-1000000,2012,Horror,David DeCoteau,-100.0,-100.0,-100.0
1434,2012-10-09,Truth or Die 2012,1000000,0,0,0,-1000000,2012,"Horror,Mystery",Robert Heath,-100.0,-100.0,-100.0
1435,2014-01-07,Hidden Away 2014,1000000,0,0,0,-1000000,2014,"Drama,Romance",Mikel Rueda,-100.0,-100.0,-100.0
1436,2013-10-08,Zombie Hunter 2013,1000000,0,0,0,-1000000,2013,"Action,Comedy,Horror",K. King,-100.0,-100.0,-100.0
1437,2014-12-31,Doc Holliday's Revenge 2014,1000000,0,0,0,-1000000,2014,Western,David DeCoteau,-100.0,-100.0,-100.0
1438,2014-06-24,A Fine Step 2014,1000000,0,0,0,-1000000,2014,Drama,Jonathan Meyers,-100.0,-100.0,-100.0
1439,2014-12-31,Bang Bang Baby 2014,1000000,0,0,0,-1000000,2014,"Drama,Fantasy,Musical",Jeffrey St. Jules,-100.0,-100.0,-100.0
1440,2016-04-08,Hush 2016,1000000,0,0,0,-1000000,2016,"Horror,Thriller",Mike Flanagan,-100.0,-100.0,-100.0
1442,2016-12-31,Chemical Cut 2016,1000000,0,0,0,-1000000,2016,Drama,Marjorie Conrad,-100.0,-100.0,-100.0
1443,2014-11-21,Food Chains 2014,913000,0,176,176,-912824,2014,Documentary,Sanjay Rawal,-100.0,-99.98072289156626,-99.98072289156626
1444,2013-07-12,Fruitvale Station 2013,900000,16098998,17549645,1450647,16649645,2013,"Biography,Drama,Romance",Ryan Coogler,1688.7775555555556,61.183,1849.9605555555554
1445,2016-04-01,Meet the Blacks 2016,900000,9097072,9097072,0,8197072,2016,"Comedy,Horror",Deon Taylor,910.7857777777778,-100.0,910.7857777777778
1446,2011-08-26,Circumstance 2011,900000,454121,958978,504857,58978,2011,Drama,Maryam Keshavarz,-49.54211111111111,-43.904777777777774,6.553111111111111
1447,2012-04-27,The Giant Mechanical Man 2012,900000,7396,7396,0,-892604,2012,"Comedy,Drama,Romance",Lee Kirk,-99.17822222222222,-100.0,-99.17822222222222
1448,2014-12-31,40 Weeks 2014,900000,0,0,0,-900000,2014,Documentary,Christopher Henze,-100.0,-100.0,-100.0
1449,2015-08-28,Windsor Drive 2015,850000,3256,3256,0,-846744,2015,"Mystery,Thriller",Natalie Bible',-99.61694117647059,-100.0,-99.61694117647059
1450,2014-09-19,Not Cool 2014,800000,35688,35688,0,-764312,2014,"Comedy,Drama,Romance",Shane Dawson,-95.539,-100.0,-95.539
1451,2011-09-09,Kevin Hart: Laugh at My Pain 2011,750000,7706436,7712436,6000,6962436,2011,"Comedy,Documentary","Tim Story, Leslie Small",927.5247999999999,-99.2,928.3248000000001
1452,2012-06-08,Safety Not Guaranteed 2012,750000,4010957,4422318,411361,3672318,2012,"Comedy,Drama,Romance",Colin Trevorrow,434.79426666666666,-45.15186666666667,489.64239999999995
1453,2014-12-31,Destiny 2014,750000,0,450,450,-749550,2014,"Adventure,Comedy,Family",Eddie Nilsson,-100.0,-99.94,-99.94
1455,2017-08-04,Columbus 2017,700000,1017107,1110511,93404,410511,2017,Drama,Kogonada,45.301,-86.65657142857143,58.64442857142858
1456,2015-03-13,Walter 2015,700000,0,0,0,-700000,2015,"Comedy,Drama",Anna Mastro,-100.0,-100.0,-100.0
1457,2013-10-11,Escape from Tomorrow 2013,650000,171962,171962,0,-478038,2013,"Drama,Fantasy,Horror",Randy Moore,-73.5443076923077,-100.0,-73.5443076923077
1458,2012-12-31,After 2012,650000,0,0,0,-650000,2012,"Drama,Fantasy,Mystery",Ryan Smith,-100.0,-100.0,-100.0
1460,2014-12-31,The Hadza: Last of the First 2014,650000,0,0,0,-650000,2014,Documentary,Bill Benenson,-100.0,-100.0,-100.0
1461,2013-12-31,Treachery 2013,625000,0,0,0,-625000,2013,"Drama,Thriller",Travis Romero,-100.0,-100.0,-100.0
1462,2015-05-22,Drunk Wedding 2015,600000,3301,3301,0,-596699,2015,Comedy,Nick Weiss,-99.44983333333333,-100.0,-99.44983333333333
1463,2014-12-31,Light from the Darkroom 2014,600000,0,0,0,-600000,2014,"Action,Drama,Thriller",Lance McDaniel,-100.0,-100.0,-100.0
1464,2015-02-24,Irreplaceable 2015,600000,0,0,0,-600000,2015,Drama,Susan Fetzer,-100.0,-100.0,-100.0
1465,2011-07-29,The Harvest/La Cosecha 2011,560000,3709,3709,0,-556291,2011,Documentary,U. Roberto Romano,-99.33767857142857,-100.0,-99.33767857142857
1466,2015-12-31,Julija in alfa Romeo 2015,560000,0,8462,8462,-551538,2015,Comedy,Blaz Zavrsnik,-100.0,-98.48892857142857,-98.48892857142857
1467,2011-07-08,Sholem Aleichem: Laughing in the Darkness 2011,500000,1131261,1131261,0,631261,2011,Documentary,Joseph Dorman,126.25219999999999,-100.0,126.25219999999999
1468,2013-08-23,Drinking Buddies 2013,500000,343706,407100,63394,-92900,2013,"Comedy,Drama,Romance",Joe Swanberg,-31.258799999999997,-87.3212,-18.58
1470,2012-09-28,The Other Dream Team 2012,500000,134109,314444,180335,-185556,2012,"Documentary,Sport",Marius A. Markevicius,-73.1782,-63.93299999999999,-37.1112
1471,2014-09-10,Born to Fly: Elizabeth Streb vs. Gravity 2014,500000,1822,1822,0,-498178,2014,"Action,Biography,Documentary",Catherine Gund,-99.6356,-100.0,-99.6356
1472,2018-05-11,Higher Power 2018,500000,528,528,0,-499472,2018,"Action,Sci-Fi,Thriller",Matthew Charles Santoro,-99.8944,-100.0,-99.8944
1474,2012-07-17,Girls Gone Dead 2012,500000,0,0,0,-500000,2012,"Comedy,Horror","Michael Hoffman Jr., Aaron T. Wells",-100.0,-100.0,-100.0
1475,2015-03-10,Subconscious 2015,500000,0,0,0,-500000,2015,"Action,Mystery,Thriller",Georgia Hilton,-100.0,-100.0,-100.0
1476,2015-06-23,Crossroads 2015,500000,0,0,0,-500000,2015,"Action,Crime,Drama",Edris Ne,-100.0,-100.0,-100.0
1477,2014-12-31,The Sound and the Shadow 2014,500000,0,0,0,-500000,2014,"Comedy,Mystery,Thriller",Justin Paul Miller,-100.0,-100.0,-100.0
1478,2014-07-11,As It Is in Heaven 2014,450000,13486,13486,0,-436514,2014,Drama,Joshua Overbay,-97.00311111111111,-100.0,-97.00311111111111
1480,2014-12-31,Pancakes 2014,400000,0,0,0,-400000,2014,Drama,Yasu Shibuya,-100.0,-100.0,-100.0
1481,2015-10-20,Rotor DR1 2015,350000,0,0,0,-350000,2015,"Family,Sci-Fi",Chad Kapper,-100.0,-100.0,-100.0
1482,2014-03-28,Locker 13 2014,300000,3496,3496,0,-296504,2014,Thriller,"Bruce Dellis, Jason Marsden, Donovan Montierth, Adam Montierth, Matthew Mebane",-98.83466666666666,-100.0,-98.83466666666666
1483,2015-10-23,The Looking Glass 2015,300000,1711,1711,0,-298289,2015,"Drama,Music",John D. Hancock,-99.42966666666668,-100.0,-99.42966666666668
1484,2014-10-31,All You Need Is Love 2014,300000,0,3565259,3565259,3265259,2014,Documentary,Stuart Cameron,-100.0,1088.4196666666667,1088.4196666666667
1485,2015-03-10,Teeth and Blood 2015,300000,0,0,0,-300000,2015,"Action,Horror","Pamela J. Richardson, Al Franklin",-100.0,-100.0,-100.0
1488,2012-08-17,Compliance 2012,270000,319285,830700,511415,560700,2012,"Biography,Crime,Drama",Craig Zobel,18.253703703703703,89.41296296296296,207.66666666666666
1489,2011-10-28,Like Crazy 2011,250000,3395391,3728400,333009,3478400,2011,"Drama,Romance",Drake Doremus,1258.1564,33.2036,1391.3600000000001
1490,2013-08-02,The Canyons 2013,250000,59671,62375,2704,-187625,2013,"Drama,Thriller",Paul Schrader,-76.1316,-98.91839999999999,-75.05
1491,2014-06-06,Test 2014,250000,18823,18823,0,-231177,2014,Drama,Aleksandr Kott,-92.4708,-100.0,-92.4708
1494,2012-12-18,The Frozen 2012,250000,0,0,0,-250000,2012,"Drama,Thriller",Andrew Hyatt,-100.0,-100.0,-100.0
1496,2015-12-31,Shooting the Warwicks 2015,250000,0,0,0,-250000,2015,"Comedy,Drama",Adam Rifkin,-100.0,-100.0,-100.0
1497,2015-10-09,Western Religion 2015,250000,0,0,0,-250000,2015,"Adventure,Drama,Fantasy",James O'Brien,-100.0,-100.0,-100.0
1498,2012-07-20,Burn 2012,225000,1109276,1109276,0,884276,2012,Documentary,"Tom Putnam, Brenna Sanchez",393.01155555555556,-100.0,393.01155555555556
1499,2015-06-19,The Overnight 2015,200000,1109808,1165996,56188,965996,2015,"Comedy,Mystery",Patrick Brice,454.904,-71.906,482.998
1500,2012-10-12,Middle of Nowhere 2012,200000,236806,236806,0,36806,2012,Drama,Ava DuVernay,18.403,-100.0,18.403
1501,2014-03-14,The Word 2014,200000,3648,3648,0,-196352,2014,"Drama,Thriller",Anna Kazejak,-98.176,-100.0,-98.176
1502,2014-12-31,H. 2014,200000,0,0,0,-200000,2014,"Drama,Sci-Fi,Thriller","Daniel Garcia, Rania Attieh",-100.0,-100.0,-100.0
1503,2011-09-23,Weekend 2011,190000,484592,1577585,1092993,1387585,2011,"Drama,Romance",Andrew Haigh,155.04842105263157,475.2594736842105,730.3078947368422
1506,2011-07-22,Another Earth 2011,175000,1321194,2102779,781585,1927779,2011,"Drama,Romance,Sci-Fi",Mike Cahill,654.9680000000001,346.62,1101.588
1507,2015-09-04,Heroes of Dirt 2015,175000,0,0,0,-175000,2015,"Action,Drama,Sport",Eric Bugbee,-100.0,-100.0,-100.0
1508,2013-12-31,Speak No Evil 2013,150000,0,32927,32927,-117073,2013,Horror,Roze,-100.0,-78.04866666666666,-78.04866666666666
1509,2013-05-03,Aroused 2013,150000,0,0,0,-150000,2013,Documentary,Deborah Anderson,-100.0,-100.0,-100.0
1510,2014-07-18,An American in Hollywood 2014,125000,0,0,0,-125000,2014,Drama,Sai Varadan,-100.0,-100.0,-100.0
1511,2015-12-31,Romantic Schemer 2015,125000,0,0,0,-125000,2015,Romance,Valentine,-100.0,-100.0,-100.0
1512,2015-07-10,The Gallows 2015,100000,22764410,41656474,18892064,41556474,2015,"Horror,Mystery,Thriller","Travis Cluff, Chris Lofing",22664.41,18792.064,41556.473999999995
1513,2017-07-07,A Ghost Story 2017,100000,1594798,2769782,1174984,2669782,2017,"Drama,Fantasy,Romance",David Lowery,1494.798,1074.9840000000002,2669.782
1514,2014-06-19,The Past is a Grotesque Animal 2014,100000,20056,20056,0,-79944,2014,"Biography,Documentary,Music",Jason Miller,-79.944,-100.0,-79.944
1515,2012-05-18,Indie Game: The Movie 2012,100000,0,0,0,-100000,2012,"Documentary,Drama","James Swirsky, Lisanne Pajot",-100.0,-100.0,-100.0
1516,2015-03-17,Closure 2015,100000,0,0,0,-100000,2015,Drama,Joseph Hovsepian,-100.0,-100.0,-100.0
1517,2015-09-29,Queen Crab 2015,75000,0,0,0,-75000,2015,"Action,Sci-Fi,Thriller",Brett Piper,-100.0,-100.0,-100.0
1518,2014-07-25,Happy Christmas 2014,70000,30312,30312,0,-39688,2014,"Comedy,Drama",Joe Swanberg,-56.69714285714286,-100.0,-56.69714285714286
1519,2011-12-31,Absentia 2011,70000,0,8555,8555,-61445,2011,"Drama,Horror,Mystery",Mike Flanagan,-100.0,-87.77857142857142,-87.77857142857142
1521,2012-12-31,Hayride 2012,60000,0,0,0,-60000,2012,"Crime,Drama,Horror",Terron R. Parsons,-100.0,-100.0,-100.0
1522,2013-10-04,The Dirties 2013,55000,0,0,0,-55000,2013,"Crime,Drama",Matt Johnson,-100.0,-100.0,-100.0
1524,2015-07-31,Counting 2015,50000,8374,8374,0,-41626,2015,Documentary,Jem Cohen,-83.25200000000001,-100.0,-83.25200000000001
1525,2014-12-31,The Image Revolution 2014,50000,0,0,0,-50000,2014,"Biography,Documentary",Patrick Meaney,-100.0,-100.0,-100.0
1526,2013-10-25,A True Story 2013,45000,0,0,0,-45000,2013,Comedy,Malcolm Goodwin,-100.0,-100.0,-100.0
1527,2013-06-21,This Is Martin Bonner 2013,42000,0,0,0,-42000,2013,Drama,Chad Hartigan,-100.0,-100.0,-100.0
1528,2011-02-11,Raymond Did It 2011,40000,3632,3632,0,-36368,2011,Horror,Travis Legge,-90.92,-100.0,-90.92
1529,2012-03-31,Foreign Letters 2012,40000,0,0,0,-40000,2012,"Comedy,Drama",Ela Thier,-100.0,-100.0,-100.0
1530,2013-10-25,Her Cry: La Llorona Investigation 2013,35000,0,0,0,-35000,2013,Horror,Damir Catic,-100.0,-100.0,-100.0
1531,2013-12-31,Paraphobia 2013,30000,0,0,0,-30000,2013,"Comedy,Horror,Thriller",Rick Montano,-100.0,-100.0,-100.0
1532,2017-01-27,Emily 2017,27000,3547,3547,0,-23453,2017,Drama,Ryan Graves,-86.86296296296297,-100.0,-86.86296296296297
1533,2015-09-01,Exeter 2015,25000,0,489792,489792,464792,2015,"Horror,Mystery,Thriller",Marcus Nispel,-100.0,1859.1680000000001,1859.1680000000001
1534,2015-12-01,Dutch Kills 2015,25000,0,0,0,-25000,2015,"Crime,Drama,Thriller",Joseph Mazzella,-100.0,-100.0,-100.0
1535,2011-11-25,The Ridges 2011,17300,0,0,0,-17300,2011,"Drama,Horror,Thriller",Brandon Landers,-100.0,-100.0,-100.0
1536,2014-12-31,Stories of Our Lives 2014,15000,0,0,0,-15000,2014,Drama,Jim Chuchu,-100.0,-100.0,-100.0
